 0 -2 0 0 3 2 3 -2 -5 -1 0 -2 -4 -3 -2 -2 -2 -2 -6 1 5 3 11 9 7 21 26 30 37 39 38 44 43 42 50 47 51 56 53 54 53 52 53 54 55 53 50 45 49 46 47 49 44 45 48 44 45 44 44 46 42 45 41 42 43 41 42 38 36 35 34 35 33 31 26 21 19 17 17 17 12 13 10 12 17 17 18 16 14 10 8 5 5 1 0 -5 -4 -6 -3 0
 -2 0 2 3 5 5 -1 -4 -6 0 1 -1 -2 -3 -2 0 1 -3 1 6 5 12 15 12 19 25 29 35 39 41 46 47 45 49 54 53 56 56 53 51 52 51 57 55 53 54 49 45 47 48 49 47 49 48 49 51 50 48 50 47 47 41 39 43 42 39 37 36 36 39 35 35 33 30 21 19 19 18 20 16 12 13 15 18 18 20 15 17 14 9 8 6 0 0 -6 -8 -7 -6 -5 0
 -5 -2 0 4 3 3 1 0 0 -3 3 0 0 -2 1 5 1 -4 3 6 2 9 13 13 24 27 31 35 39 38 48 47 45 50 54 57 57 55 48 53 52 53 55 54 49 54 53 46 46 47 54 49 52 53 57 55 53 55 54 50 54 44 43 43 41 40 36 34 37 37 37 35 37 34 19 21 21 18 21 18 15 15 12 18 24 19 13 14 21 8 7 9 0 -4 -9 -12 -10 -7 -10 -1
 -8 -4 -6 2 3 1 3 3 6 3 7 10 4 2 1 3 2 9 0 3 4 9 10 13 25 30 37 38 42 47 49 50 52 53 52 54 57 57 57 52 56 59 56 53 52 54 53 49 48 49 54 53 56 65 63 57 61 59 59 52 51 46 38 35 40 36 39 36 34 36 37 31 32 33 21 23 20 18 25 23 16 23 24 28 30 30 13 16 15 10 2 0 -2 -3 -4 -11 -9 -3 -1 -3
 -12 -5 -4 1 6 7 6 7 8 11 13 10 6 5 5 2 2 2 2 3 5 8 9 12 27 30 34 39 41 45 51 53 53 54 51 54 63 64 58 56 58 55 54 56 57 57 55 51 47 54 59 59 64 66 65 64 63 63 57 52 50 40 38 40 38 35 35 33 32 37 35 33 31 34 19 22 21 23 28 25 24 24 29 34 35 35 10 12 10 4 1 0 0 0 -3 -7 -6 -3 -4 -5
 -20 -11 -10 1 6 12 11 9 7 10 12 5 7 4 0 2 -1 -1 5 5 7 6 11 10 30 31 34 37 44 44 52 55 59 53 53 57 65 65 61 53 53 53 53 55 56 61 56 56 58 57 59 61 67 68 69 67 64 63 58 56 49 34 37 40 38 36 32 32 32 35 33 36 33 35 21 22 21 24 26 25 26 27 33 33 36 37 10 10 9 6 3 -1 1 1 -1 -4 -8 -3 -8 -5
 -25 -15 -11 -6 -1 3 9 7 4 2 10 12 7 9 3 7 6 2 1 10 10 14 18 21 31 32 40 39 48 50 55 58 60 61 64 62 68 63 61 60 57 55 52 56 54 53 54 50 51 56 61 66 68 64 65 69 58 59 59 49 49 39 34 31 35 32 33 35 32 33 31 34 37 37 20 25 27 25 28 27 29 34 34 33 30 35 7 5 3 -1 1 2 2 4 4 0 -7 -6 -1 -1
 -22 -17 -13 -8 -8 0 7 8 9 12 11 11 10 13 11 17 12 7 9 12 13 22 24 22 37 36 37 49 53 57 58 57 59 65 66 66 70 66 62 60 59 56 58 58 52 55 53 50 49 61 63 66 63 60 61 59 55 55 47 43 47 33 29 31 30 30 34 34 31 31 32 35 37 35 24 28 28 30 33 30 32 36 36 31 26 29 9 7 4 3 2 6 7 10 4 0 -3 -6 -2 0
 -24 -22 -17 -9 -7 -5 8 7 10 14 10 15 14 17 18 22 14 11 12 16 18 25 23 20 37 40 41 53 55 57 61 62 64 70 72 73 75 69 64 61 63 60 59 59 54 55 58 52 54 60 65 63 54 54 55 58 52 48 49 45 47 34 29 29 27 32 34 35 33 30 31 30 34 37 24 28 34 34 29 32 28 33 30 35 27 29 8 7 0 3 5 11 7 7 1 0 0 -4 -3 1
 -29 -22 -21 -11 -7 -8 4 6 7 12 14 19 17 26 27 23 17 16 16 21 21 23 22 22 42 50 46 52 63 63 65 76 73 74 79 81 76 75 75 64 65 66 60 60 60 57 57 57 53 63 58 58 54 46 44 53 45 44 44 41 37 33 32 34 31 35 33 36 32 30 33 37 38 42 25 31 32 31 29 30 28 29 30 33 29 30 9 5 5 5 12 15 9 10 8 5 4 4 -2 0
 -26 -21 -19 -10 -7 -7 0 4 7 10 11 16 27 29 30 25 23 16 19 22 21 24 24 23 52 56 53 63 65 65 77 83 79 81 83 83 81 81 77 70 68 68 63 61 62 59 57 57 56 56 56 53 45 42 38 41 39 43 39 40 39 30 31 28 35 39 39 37 33 32 35 37 37 41 26 27 28 32 31 30 27 24 28 29 31 26 11 6 8 16 13 18 16 15 8 11 9 5 1 1
 -29 -22 -18 -12 -9 -5 -4 2 7 16 10 21 27 29 33 24 23 21 17 20 22 26 25 26 56 58 58 63 66 70 74 79 78 85 84 90 87 87 80 77 71 73 69 64 66 64 60 59 49 56 53 51 40 38 38 35 32 37 33 33 33 33 30 29 38 40 41 42 36 37 39 42 38 43 26 30 29 32 31 31 30 25 29 30 28 23 15 14 15 23 20 22 21 15 14 15 11 5 10 1
 -29 -26 -23 -17 -7 -1 0 5 6 10 18 22 29 28 25 22 24 23 26 25 27 25 29 31 57 60 60 61 66 72 66 72 74 79 86 91 90 84 81 79 77 77 74 70 63 57 53 50 50 54 55 52 57 50 46 46 45 47 42 40 39 31 30 31 29 26 29 32 33 33 32 33 32 38 24 13 12 14 5 1 4 3 3 6 11 16 24 27 30 29 25 28 31 19 18 12 15 6 6 7
 -29 -27 -23 -11 -8 -5 2 5 8 14 20 22 26 28 24 25 26 28 27 27 28 27 30 32 61 62 62 67 71 70 67 72 75 80 84 85 83 79 79 74 74 71 64 63 59 51 49 48 47 57 58 58 55 50 47 51 49 46 44 40 35 34 34 31 24 22 25 27 28 29 27 28 30 34 15 12 14 4 0 0 0 2 4 7 8 16 23 23 25 22 18 22 18 19 19 15 10 5 9 12
 -33 -27 -16 -15 -10 -6 0 4 5 15 18 19 26 27 25 23 27 30 28 26 24 31 31 36 59 64 63 64 67 72 66 70 68 75 82 85 81 79 77 71 72 63 57 58 54 45 48 45 44 61 63 61 57 55 50 52 50 47 44 41 29 34 34 32 24 22 22 19 23 24 22 25 28 37 8 9 9 5 1 4 1 3 3 8 9 13 21 22 26 23 17 16 18 16 16 14 13 13 17 18
 -32 -25 -23 -15 -12 -6 0 -1 2 11 19 26 23 24 24 27 33 31 31 32 28 33 39 42 61 64 66 63 65 69 64 68 68 75 85 85 80 77 71 68 60 56 53 51 44 38 39 37 38 67 68 67 61 56 52 55 58 52 50 40 36 36 31 28 23 15 14 14 15 19 17 23 33 35 10 8 7 6 3 3 -1 3 9 9 11 15 22 25 24 21 13 17 14 15 14 13 15 22 25 24
 -31 -27 -25 -14 -11 -11 -6 -5 3 15 18 20 23 24 27 31 32 34 37 36 34 42 45 43 65 67 66 65 66 64 67 68 71 76 82 85 76 75 69 62 57 54 50 51 45 37 39 37 41 67 66 67 62 60 58 59 59 56 48 43 37 31 32 26 15 12 12 13 14 14 15 25 33 33 7 7 5 4 6 7 2 5 8 12 11 11 21 25 21 13 10 10 10 13 14 13 18 23 25 27
 -33 -31 -27 -19 -16 -17 -7 -3 4 14 15 21 24 28 30 32 32 33 39 37 38 42 46 46 63 66 62 61 67 64 66 68 68 75 79 75 76 72 70 58 52 45 44 44 39 37 34 36 37 72 68 72 68 68 64 62 59 59 46 44 39 25 21 16 14 9 9 9 8 13 11 22 27 25 8 6 6 5 4 6 5 5 8 10 13 13 19 19 13 9 7 2 5 10 14 10 18 25 28 27
 -38 -32 -34 -32 -26 -21 -9 -7 -1 2 14 19 23 26 31 32 38 36 39 39 39 40 46 47 65 63 64 64 65 65 64 67 68 69 73 74 75 65 61 57 49 44 38 40 40 43 41 44 40 71 71 70 76 71 69 67 57 54 49 41 34 17 17 14 10 9 7 7 11 17 20 21 21 26 5 1 -1 0 0 3 3 2 6 4 6 9 17 8 8 7 0 0 1 8 9 12 19 16 24 31
 -37 -32 -34 -32 -27 -20 -9 -6 0 7 14 16 24 25 27 36 39 40 37 37 37 45 51 52 65 62 61 63 68 64 68 69 68 69 72 70 68 65 61 55 53 48 44 44 46 47 46 45 41 71 68 70 71 69 68 59 58 51 44 43 37 21 18 15 12 12 11 11 10 15 22 23 20 20 5 4 1 2 1 1 1 1 0 4 6 9 14 13 10 0 0 2 8 11 10 12 14 16 23 30
 -41 -40 -41 -36 -26 -18 -9 -3 2 5 12 16 24 26 23 34 36 40 37 38 42 47 48 54 65 63 60 61 64 61 64 67 67 67 70 71 68 64 61 53 53 53 46 47 47 49 48 47 40 72 69 66 64 65 67 54 52 47 35 38 32 23 22 18 11 16 9 14 15 15 18 16 18 17 1 3 2 2 0 -2 0 -1 3 0 7 7 9 10 2 1 0 6 15 13 11 11 16 16 20 26
 -44 -46 -43 -33 -24 -18 -7 -3 1 8 14 20 24 22 24 31 36 38 40 45 45 49 58 59 64 61 56 56 59 63 65 64 65 67 67 66 64 58 57 56 55 52 52 55 54 53 47 47 46 72 68 67 63 62 62 54 51 46 35 36 35 23 19 16 17 14 19 15 17 17 16 19 19 19 6 5 6 2 0 -3 0 0 1 1 2 7 8 4 1 0 6 9 14 17 16 12 21 14 19 24
 -44 -43 -41 -29 -23 -17 -10 -6 -1 8 13 18 22 20 26 32 34 41 45 48 46 55 55 61 60 59 55 54 56 58 67 65 64 65 66 63 61 58 58 64 60 60 58 57 55 53 52 47 47 66 67 65 61 62 64 56 60 52 39 42 34 23 22 20 19 15 15 17 18 17 14 15 18 18 7 7 7 2 0 0 4 3 2 0 0 3 5 3 2 7 10 9 16 20 18 11 12 12 18 23
 -43 -44 -35 -32 -28 -27 -15 -9 -5 8 12 17 21 22 23 31 35 45 49 50 54 61 58 63 62 59 54 54 59 62 64 61 64 61 63 60 59 62 61 69 66 67 64 61 58 57 54 49 52 62 66 66 61 62 63 58 54 46 42 38 31 22 24 21 20 17 21 19 17 10 9 16 15 15 9 8 7 4 2 0 4 3 4 0 1 1 5 4 3 13 10 10 15 15 17 10 15 13 17 20
 -47 -37 -36 -32 -27 -20 -12 -9 -6 -2 0 2 6 15 20 24 32 35 38 42 50 49 54 62 61 58 58 60 54 53 55 57 61 64 58 58 61 57 55 53 51 53 52 51 54 49 52 46 44 63 57 59 53 48 49 46 49 42 43 35 34 32 34 30 31 25 24 21 20 19 13 11 8 6 8 8 9 13 15 18 14 9 8 4 -1 -1 0 -2 0 4 5 6 9 12 17 18 21 15 20 20
 -45 -40 -36 -31 -28 -20 -14 -11 -9 -3 -1 0 7 11 17 25 28 33 33 34 37 45 50 54 55 54 52 50 51 50 50 49 53 51 52 56 54 57 56 51 52 53 47 47 49 45 44 46 46 58 56 55 50 46 46 53 51 47 39 33 35 35 34 33 28 26 21 19 19 16 11 10 9 8 9 7 12 18 15 13 11 9 7 -1 -4 -4 -6 -4 0 1 3 4 13 13 16 19 16 15 17 22
 -44 -42 -38 -35 -27 -27 -19 -16 -15 -7 -4 -5 7 13 19 26 27 32 31 28 38 40 44 53 54 50 47 52 49 51 48 48 46 47 49 52 49 53 54 50 47 47 48 45 37 44 44 46 46 56 56 55 59 54 56 55 50 47 38 36 32 36 36 39 31 31 29 17 17 12 13 13 12 6 13 11 16 18 16 10 7 6 6 -5 -3 -8 -5 -4 0 4 4 5 14 17 23 21 19 20 19 22
 -48 -45 -38 -31 -26 -20 -20 -17 -11 -11 -13 -11 7 8 13 22 27 27 27 26 27 34 36 46 50 47 48 44 49 49 47 38 40 43 42 41 47 44 47 48 45 45 43 41 41 41 42 42 45 54 57 55 60 63 60 53 50 49 42 41 38 39 41 35 35 32 30 20 21 17 16 16 15 11 12 14 16 19 12 14 4 2 0 -1 -9 -5 -6 -2 2 2 1 1 16 20 23 23 28 28 31 30
 -51 -48 -44 -31 -23 -23 -20 -19 -16 -17 -20 -16 -4 0 5 18 26 23 21 23 23 31 32 40 48 48 46 47 52 47 35 34 36 37 37 39 38 38 41 40 39 42 42 42 42 42 42 42 46 51 53 57 64 65 66 56 52 52 47 43 41 42 44 42 34 31 27 27 27 22 17 16 16 14 15 16 17 14 9 8 0 -1 0 -7 -12 -9 -8 -2 0 0 0 3 15 17 20 23 24 29 31 34
 -57 -53 -45 -36 -30 -28 -24 -20 -21 -20 -22 -18 -8 -4 -1 10 16 16 14 21 19 29 31 35 50 47 46 43 47 42 40 34 37 31 31 30 37 36 29 39 38 41 44 43 44 44 44 44 47 53 52 55 66 69 69 64 58 53 50 49 49 43 42 43 37 33 33 27 28 25 19 16 16 15 18 15 17 14 7 6 1 -3 -3 -5 -8 -7 -13 -7 -5 0 2 5 13 16 18 20 23 29 31 34
 -56 -50 -49 -44 -37 -36 -27 -27 -28 -28 -27 -26 -14 -11 -4 1 0 3 15 16 16 17 24 29 45 41 41 36 35 38 32 32 28 33 24 26 32 34 33 35 33 34 43 41 38 38 43 39 40 54 57 60 59 63 67 69 66 64 63 58 58 44 44 41 41 37 34 32 23 21 21 18 15 8 15 14 12 11 6 2 -2 -4 -8 -7 -10 -11 -15 -16 -9 -4 -1 2 11 17 18 23 24 27 35 33
 -49 -47 -46 -42 -38 -33 -27 -27 -29 -32 -30 -28 -20 -17 -11 -4 -5 1 7 11 11 18 23 27 39 41 38 32 35 31 28 30 32 23 20 22 27 32 36 28 30 33 39 38 40 33 37 38 40 56 55 57 58 58 66 66 68 63 58 56 55 49 49 48 43 42 38 22 19 23 18 16 16 13 15 16 13 6 5 0 -4 -6 -6 -9 -11 -11 -19 -23 -13 -3 -2 5 15 19 23 24 25 27 27 31
 -43 -46 -43 -44 -38 -39 -33 -31 -32 -32 -32 -30 -19 -19 -13 -4 -5 0 3 5 7 12 19 25 37 39 36 29 31 27 23 27 25 21 18 19 17 27 28 27 24 25 27 38 37 34 37 37 36 65 56 55 59 59 62 60 63 59 59 58 56 50 48 47 42 43 38 21 17 18 18 16 16 14 12 14 15 6 4 0 -4 -5 -5 -6 -12 -15 -15 -18 -7 0 0 5 16 19 23 24 24 23 24 29
 -46 -47 -45 -43 -43 -44 -39 -41 -43 -37 -34 -33 -27 -17 -11 -8 -7 -2 -1 1 2 11 18 23 34 31 30 27 22 16 18 17 17 17 8 10 15 17 16 22 12 12 31 31 30 30 25 29 32 59 53 51 57 58 63 59 60 55 57 60 59 51 47 52 44 41 35 19 19 16 15 14 11 10 15 11 11 3 1 -4 -5 -6 -5 -10 -13 -13 -12 -7 0 1 9 12 14 18 21 28 24 25 26 29
 -49 -48 -48 -45 -45 -43 -46 -47 -44 -40 -37 -37 -27 -19 -20 -13 -9 -5 -1 0 2 12 18 24 24 23 21 21 20 16 12 13 10 4 4 1 7 10 11 8 7 10 24 26 28 26 27 28 31 54 54 53 58 56 60 60 61 61 60 62 61 53 47 48 43 40 36 22 22 20 13 10 12 7 13 11 8 1 2 -4 -7 -5 -9 -15 -13 -15 -11 -8 -3 5 10 14 20 22 24 29 27 24 28 32
 -47 -44 -47 -41 -44 -42 -44 -45 -47 -44 -41 -41 -34 -26 -22 -19 -12 -9 0 0 1 14 20 25 24 20 22 13 14 9 6 6 0 0 -3 0 -3 1 -2 0 5 8 20 21 20 22 24 31 34 55 55 50 58 56 57 61 61 62 63 62 62 58 52 45 42 43 36 27 20 18 13 7 14 7 18 9 7 1 0 -3 -13 -10 -11 -21 -16 -14 -13 -11 0 7 12 15 21 22 22 27 30 27 30 33
 -43 -41 -40 -40 -40 -40 -42 -42 -46 -43 -43 -39 -37 -31 -22 -17 -6 0 7 14 15 16 15 22 20 13 12 12 9 6 3 0 0 -1 -6 -10 -14 -4 1 0 3 7 12 20 27 31 38 40 38 52 47 49 51 52 50 51 56 59 57 59 60 56 41 39 35 27 22 19 18 12 13 12 11 4 10 4 5 2 4 8 2 -6 -13 -13 -15 -13 -15 -8 -7 0 11 13 19 22 21 21 23 23 25 30
 -46 -46 -43 -39 -37 -42 -45 -44 -45 -44 -38 -39 -38 -32 -24 -12 -5 2 9 14 15 10 12 18 5 5 4 1 1 0 -7 -2 -5 -8 -6 -12 -3 0 0 4 2 9 21 20 25 28 37 41 42 47 44 46 51 53 54 52 56 57 58 58 57 43 40 39 31 28 22 17 19 19 11 10 10 5 5 1 1 7 7 4 -1 -4 -6 -9 -11 -15 -12 -10 -4 6 13 16 18 21 23 21 23 23 24 29
 -47 -48 -49 -42 -40 -41 -46 -47 -48 -46 -41 -38 -44 -32 -28 -10 -7 4 11 10 12 12 14 17 3 2 4 -2 -1 -6 -10 -9 -13 -14 -11 -10 -2 4 2 10 10 19 16 21 23 28 33 40 45 47 44 47 56 54 53 54 53 53 55 53 51 40 37 38 32 30 25 19 20 20 12 6 7 5 7 4 1 5 8 4 -2 1 -4 -7 -8 -8 -9 -8 -2 8 11 18 14 19 22 21 20 25 27 30
 -45 -42 -43 -43 -41 -47 -47 -51 -50 -46 -40 -37 -43 -34 -29 -14 -3 4 6 8 11 10 10 11 0 -11 -6 -6 -14 -13 -18 -19 -18 -18 -23 -23 4 8 11 14 22 23 23 26 32 29 32 35 39 45 46 48 53 57 58 52 50 53 53 45 46 36 36 36 30 24 24 18 15 12 8 4 -1 -1 9 10 9 7 4 5 2 1 2 -2 -5 -8 -6 -2 1 7 15 15 15 20 25 19 24 22 26 24
 -42 -40 -41 -40 -40 -41 -50 -50 -50 -45 -42 -41 -44 -38 -28 -12 -2 5 7 5 6 7 8 10 -10 -18 -15 -20 -21 -19 -21 -18 -18 -21 -26 -26 9 11 10 22 24 29 24 23 26 28 29 34 37 42 40 44 56 59 59 48 47 51 44 38 43 35 37 33 26 25 23 17 16 11 4 1 -4 -9 12 11 8 6 3 8 5 3 1 -3 -6 -6 -5 -6 1 7 15 16 17 20 19 15 18 21 22 23
 -41 -43 -44 -44 -43 -47 -49 -50 -51 -48 -43 -40 -42 -38 -33 -14 -3 -1 6 6 12 6 10 10 -13 -19 -20 -22 -24 -19 -23 -20 -15 -19 -22 -27 9 12 12 20 25 32 29 26 32 29 30 29 33 44 45 50 57 59 58 48 48 50 45 40 42 29 32 33 31 27 27 18 10 6 0 -4 -8 -14 15 13 8 6 5 7 2 1 0 -2 -1 -5 -7 -3 0 3 10 14 13 14 15 13 11 18 19 18
 -41 -45 -46 -45 -50 -50 -51 -54 -53 -51 -46 -47 -48 -34 -29 -20 -8 1 6 5 9 4 0 -1 -15 -21 -22 -26 -27 -23 -26 -25 -30 -26 -21 -25 6 17 20 22 26 25 30 25 25 25 23 28 30 45 44 46 49 49 52 52 47 47 43 41 41 28 24 19 22 24 18 13 9 10 4 -4 -11 -19 13 5 7 3 2 4 2 2 -2 0 -2 -4 -3 2 6 5 6 13 10 11 13 15 15 14 18 11
 -43 -46 -45 -45 -48 -48 -55 -56 -53 -50 -47 -45 -41 -33 -28 -16 -7 -2 0 3 0 -5 -8 -3 -24 -24 -26 -27 -29 -28 -24 -29 -27 -20 -17 -19 11 18 17 25 27 24 26 24 28 24 25 27 30 38 39 41 44 48 49 47 47 47 41 39 39 26 24 22 24 28 25 10 12 11 6 -2 -12 -17 3 0 0 2 0 0 0 0 -2 -1 -2 -1 1 2 2 4 3 5 5 9 14 15 13 15 12 9
 -47 -48 -46 -48 -48 -54 -56 -57 -53 -54 -48 -41 -48 -36 -30 -20 -11 -4 -7 -1 -3 -4 -5 -2 -24 -27 -29 -31 -27 -24 -24 -25 -25 -18 -17 -16 7 14 14 20 24 30 23 25 28 27 27 28 33 38 37 36 37 43 47 45 45 42 42 36 36 26 25 19 20 24 19 10 7 4 9 0 -6 -18 -3 1 0 6 1 0 0 -2 -1 -1 -2 -3 0 1 5 2 0 1 2 8 16 17 16 17 10 9
 -50 -49 -47 -48 -50 -51 -56 -57 -57 -47 -43 -40 -42 -39 -35 -19 -14 -9 -12 -12 -10 -8 -10 -13 -28 -29 -32 -30 -29 -26 -20 -21 -22 -19 -17 -17 9 13 15 20 18 19 24 26 25 27 29 30 30 34 34 31 37 39 40 42 42 45 40 41 41 27 25 22 17 16 16 6 8 9 11 1 -7 -13 0 3 4 5 3 1 -3 -6 -6 -2 0 0 -2 -2 -3 0 0 0 8 13 17 23 20 15 13 9
 -50 -50 -47 -50 -49 -55 -54 -55 -54 -47 -47 -42 -40 -42 -38 -21 -19 -18 -12 -12 -14 -14 -12 -12 -28 -31 -32 -27 -25 -30 -23 -22 -22 -16 -11 -13 4 6 10 17 17 18 21 22 20 26 27 29 34 35 36 36 39 38 35 38 37 39 37 39 35 21 20 15 19 11 10 7 6 3 4 -6 -9 -16 -1 1 2 1 1 -1 -4 -6 -4 -4 -2 5 5 2 1 -2 2 -3 4 6 7 16 18 12 13 7
 -49 -49 -49 -50 -49 -50 -48 -49 -48 -48 -48 -46 -43 -42 -38 -27 -28 -24 -14 -15 -11 -14 -13 -13 -29 -34 -33 -22 -22 -22 -20 -20 -20 -13 -11 -9 3 4 7 15 16 17 16 17 20 25 29 31 33 36 39 35 38 39 35 31 32 32 35 35 32 17 15 17 9 10 9 1 0 0 0 -4 -13 -16 -1 0 0 1 2 -1 -5 -6 -5 2 2 4 7 6 3 0 -1 -4 -2 -2 3 9 12 11 9 8
 -50 -51 -48 -51 -49 -52 -46 -47 -47 -46 -49 -47 -47 -41 -39 -28 -29 -23 -23 -24 -19 -17 -18 -17 -28 -29 -24 -21 -21 -23 -21 -20 -24 -19 -14 -12 0 1 1 10 15 14 16 16 22 25 28 32 31 35 33 29 29 32 29 25 27 26 29 30 29 18 19 17 10 8 8 2 0 -2 -4 -8 -11 -15 -12 -8 -8 -3 0 -4 -5 -4 -6 6 5 6 7 8 1 -1 -2 -3 -6 -6 -4 2 1 5 4 8
 -54 -48 -46 -38 -35 -34 -31 -23 -21 -19 -9 -3 -4 8 12 13 23 29 36 40 41 44 43 46 47 44 43 41 43 44 38 39 38 35 40 37 36 39 38 36 32 29 24 28 32 32 34 34 36 31 25 22 25 24 29 32 34 31 27 23 30 25 24 27 15 10 7 5 0 -1 2 2 5 2 -4 -3 -5 -1 0 -3 -2 -3 0 -1 5 7 12 10 14 13 16 16 11 13 9 8 4 13 9 5
 -51 -48 -43 -36 -37 -36 -27 -25 -23 -14 -10 -5 6 10 11 18 23 32 36 38 38 43 43 43 46 44 42 44 44 44 41 43 41 45 47 43 45 45 41 38 38 33 28 27 29 33 32 33 33 24 23 23 22 24 27 35 38 31 25 22 26 25 25 17 11 11 6 0 -4 0 2 5 8 4 -7 -6 -2 0 1 0 -4 -2 -3 0 2 5 7 6 11 14 16 14 12 13 10 8 11 15 12 6
 -43 -46 -37 -36 -33 -28 -23 -24 -24 -17 -10 -8 4 12 13 16 27 37 33 37 37 40 40 42 44 43 44 43 42 45 48 45 46 45 49 50 48 48 44 37 37 30 32 27 29 32 30 32 32 24 19 19 19 24 33 35 33 28 25 25 29 25 20 16 14 8 8 0 1 0 7 6 6 5 -7 -8 -1 -1 -1 -5 -6 -2 -3 -1 4 7 7 4 10 15 11 15 12 11 6 5 11 8 7 4
 -47 -43 -41 -33 -30 -22 -24 -23 -22 -19 -12 -9 11 16 14 23 35 42 34 44 42 35 35 36 44 35 40 41 42 46 46 48 48 48 55 56 53 51 51 41 41 39 33 34 31 30 28 23 28 17 13 15 19 28 31 33 29 24 27 34 42 23 18 14 12 8 4 6 4 7 10 11 16 10 -10 -9 -6 -1 -2 -2 -4 -1 -4 2 4 4 5 6 10 9 9 8 11 8 2 2 1 4 4 2
 -49 -45 -40 -36 -32 -24 -20 -21 -22 -12 -12 -6 19 20 18 32 37 43 44 50 42 35 36 34 34 30 35 40 43 47 47 49 50 58 60 58 57 55 50 42 42 38 37 36 33 30 26 21 21 13 12 11 21 28 33 32 29 30 37 38 38 23 19 20 16 11 6 2 0 6 12 15 20 16 -9 -12 -7 -4 -4 -5 -7 -2 -1 0 1 5 2 3 5 6 4 8 11 7 3 2 2 4 2 2
 -52 -45 -42 -35 -31 -25 -17 -18 -19 -11 -7 -11 20 23 22 32 34 38 41 41 41 34 36 33 31 34 36 39 43 46 54 50 49 56 59 61 57 56 46 42 44 44 41 33 31 28 26 25 28 15 12 14 23 26 34 29 29 30 41 39 38 25 22 21 16 11 4 4 4 6 14 17 18 18 -9 -8 -4 -7 -8 -14 -11 -8 -5 -3 -1 -1 -2 0 1 4 7 7 11 6 3 0 3 3 6 2
 -51 -42 -38 -33 -22 -14 -12 -4 -6 -3 -2 0 21 25 32 30 38 41 40 35 33 30 30 27 31 36 40 44 48 53 53 56 59 57 60 62 61 58 52 51 51 46 37 37 43 37 34 30 30 15 17 20 21 22 29 30 34 33 35 31 35 30 26 23 19 7 5 6 6 11 9 12 14 19 -5 -2 -5 -3 -2 -8 -13 -9 -8 -6 -4 -6 -3 0 0 2 6 7 8 8 3 9 7 8 7 3
 -45 -38 -34 -24 -18 -12 -1 -3 -2 0 0 0 24 26 27 31 33 36 36 34 30 27 28 26 31 33 37 45 45 48 54 59 60 59 62 67 64 61 55 55 53 50 38 38 38 35 32 29 26 14 15 15 20 22 29 30 35 35 28 28 34 26 24 22 13 6 6 7 6 10 9 11 14 18 -4 0 0 3 4 -6 -11 -9 -5 -6 -6 -5 0 0 2 5 7 8 8 6 5 9 7 8 10 7
 -46 -38 -32 -19 -14 -10 -5 0 -3 0 2 3 19 24 29 30 32 36 34 33 28 23 25 27 29 33 39 45 47 48 53 58 60 67 66 66 68 62 63 55 52 46 37 39 38 34 29 26 26 10 14 16 18 24 29 30 33 28 27 30 30 24 23 19 12 9 8 10 9 12 10 7 15 21 -3 0 0 3 -1 -4 -12 -11 -8 -7 -4 -5 -1 2 2 9 8 13 7 9 6 7 6 9 11 9
 -39 -26 -23 -17 -10 -8 1 0 1 3 7 7 20 26 27 29 34 34 34 26 25 22 21 23 26 28 32 42 46 48 52 58 61 65 73 77 68 65 64 57 44 46 37 38 38 34 32 30 19 13 16 17 20 26 31 28 25 26 26 27 32 25 22 21 16 14 9 11 12 8 10 12 14 12 -5 2 7 3 -2 -5 -11 -7 -8 -5 -5 -6 -2 6 4 10 10 14 14 9 11 8 8 15 14 15
 -30 -25 -22 -13 -9 -4 3 2 2 8 7 10 20 24 26 30 33 32 30 29 25 22 19 21 23 26 32 41 44 48 54 61 63 72 74 74 70 67 65 50 42 43 41 42 39 35 31 29 24 12 14 15 22 29 27 24 24 21 23 29 27 23 21 19 14 12 12 15 14 11 10 13 13 10 2 8 7 1 1 -3 -5 -6 -4 -7 -3 -3 0 5 7 5 8 13 13 11 11 9 14 18 18 17
 -32 -26 -24 -11 -7 -3 3 6 8 8 10 17 24 24 25 30 29 32 33 32 31 23 24 26 16 24 30 38 39 43 54 57 65 70 77 77 69 69 70 58 52 44 45 44 39 35 31 24 20 12 15 18 20 25 22 21 21 18 24 27 27 26 24 18 23 16 20 11 9 13 9 8 11 16 7 3 7 -1 -1 -1 0 -3 -3 -6 -5 -3 0 2 8 6 10 13 12 9 12 14 14 17 19 16
 -35 -33 -29 -29 -15 -14 -9 -7 -1 3 9 19 23 24 24 27 24 24 23 23 21 23 24 22 15 27 30 30 39 49 51 53 55 60 66 68 74 63 57 58 48 50 48 38 37 28 22 15 18 11 16 16 22 34 34 35 32 30 31 28 29 26 33 29 24 20 22 13 15 12 17 15 17 16 0 2 1 0 4 5 2 2 6 6 0 -3 -4 4 3 5 11 12 12 10 13 18 17 19 23 19
 -30 -30 -28 -14 -10 -7 -5 -6 -1 8 10 16 25 25 27 30 25 20 22 23 25 23 22 22 17 23 24 30 35 43 47 50 51 54 60 60 60 57 54 44 43 44 32 29 31 24 18 13 17 13 19 21 32 38 39 35 36 37 33 30 27 32 36 30 26 26 19 16 15 16 19 17 19 15 4 6 6 1 4 0 3 7 12 4 0 -2 2 5 5 13 13 11 8 8 11 19 17 18 21 21
 -26 -26 -24 -12 -6 -2 0 0 9 11 15 21 25 26 26 30 25 26 21 23 21 20 22 21 15 20 25 25 34 41 39 46 45 47 49 52 53 53 48 38 38 33 29 24 29 17 15 15 16 11 18 20 29 35 34 39 38 35 34 31 29 35 33 28 25 25 20 20 19 16 17 16 18 17 5 6 0 1 2 5 6 12 13 6 5 -1 2 8 10 15 11 10 6 11 15 18 19 20 23 21
 -22 -15 -12 -6 1 5 4 9 8 17 22 25 26 27 28 29 27 26 24 21 20 22 19 17 14 16 19 25 34 40 39 39 36 41 39 40 51 44 41 34 28 23 21 17 15 7 9 11 11 10 16 22 30 38 38 37 44 44 35 30 27 32 28 26 23 25 20 20 15 15 18 12 17 20 1 0 -4 0 0 -2 10 11 15 14 8 4 6 13 14 13 8 8 9 10 13 17 20 23 22 21
 -14 -9 -4 3 7 9 11 12 14 23 26 26 28 27 30 30 29 31 21 21 20 21 19 15 15 16 15 27 32 39 38 36 35 34 36 33 42 40 36 24 22 21 10 11 7 1 7 10 10 11 13 20 34 37 41 46 44 41 34 31 30 29 27 28 30 28 26 16 9 12 18 18 17 22 0 0 0 -4 -4 -1 2 7 11 8 7 5 15 16 14 10 4 5 10 11 15 17 19 24 22 23
 -11 -8 -2 3 11 11 7 13 12 26 26 25 28 31 29 29 29 28 26 19 19 24 18 14 11 15 19 28 32 39 31 30 29 27 30 30 40 35 33 24 16 16 2 4 5 -1 1 4 9 9 20 26 36 39 40 46 43 35 34 29 31 33 31 32 29 28 23 22 17 19 21 24 22 26 0 0 -5 -5 -6 -2 5 6 7 6 5 8 20 17 9 7 6 4 12 12 14 18 21 23 24 24
 -10 -2 1 0 6 12 14 21 25 23 21 27 30 24 24 25 23 20 23 22 18 14 12 10 12 18 21 27 27 33 30 22 19 18 13 11 32 21 14 12 7 6 2 1 -2 -1 -1 0 2 15 29 30 38 40 45 43 38 36 36 34 29 32 31 29 27 25 22 22 19 18 21 20 25 29 0 -2 -1 -1 0 0 3 7 7 7 7 8 25 15 12 8 3 7 7 8 10 13 16 18 20 21
 -3 0 1 1 4 7 15 20 22 21 22 21 20 20 20 21 21 23 22 25 19 17 15 11 12 15 18 19 22 23 19 18 14 9 7 6 18 15 10 9 6 4 4 5 3 4 0 0 -1 26 33 35 41 41 43 36 38 40 37 36 33 29 29 29 25 23 19 20 19 22 22 24 27 24 0 -1 -2 3 4 5 8 12 10 9 7 9 23 15 12 7 3 4 12 11 12 13 16 15 18 19
 -1 0 2 1 7 7 13 18 23 19 22 21 24 20 17 22 21 25 18 18 21 16 14 8 9 12 13 11 17 17 14 15 7 4 5 0 16 10 7 8 8 1 1 5 9 7 3 0 0 26 33 37 44 41 38 35 38 38 37 35 35 29 29 27 25 22 21 13 19 19 24 24 27 24 4 5 2 7 8 7 10 15 9 8 5 6 18 16 12 7 7 4 17 16 17 14 19 16 15 14
 0 0 0 4 5 9 16 16 20 21 20 18 20 20 18 18 21 23 16 19 20 12 10 10 5 7 7 10 8 8 7 7 5 -1 -4 -5 6 3 3 6 2 1 4 6 9 12 6 0 -6 31 35 38 41 38 38 34 37 37 34 31 29 26 23 24 20 17 15 14 17 21 22 23 24 26 5 5 5 12 11 14 12 12 10 10 9 9 19 15 12 13 14 14 18 17 17 16 15 13 13 12
 4 4 2 0 4 6 14 10 18 19 20 17 19 19 17 16 14 18 18 18 19 13 11 9 5 5 7 6 5 7 6 3 1 -3 -8 -9 3 1 1 0 0 0 0 4 2 7 4 0 -6 33 31 35 32 34 35 30 35 33 36 27 25 24 24 27 21 17 20 15 18 20 25 21 23 21 11 10 10 11 16 17 14 12 22 15 14 12 20 17 15 17 15 22 17 16 18 14 13 6 13 12
 5 6 4 2 1 2 6 7 9 17 18 17 20 20 17 11 8 13 13 15 12 12 14 8 3 5 1 6 7 -1 0 0 -1 -11 -10 -13 -3 -2 -3 -2 -3 -3 1 1 0 1 0 -3 -8 32 30 33 31 30 32 29 32 32 27 27 24 26 27 23 18 17 17 18 20 21 23 24 22 20 15 15 15 19 21 22 16 16 16 18 19 18 20 18 19 18 19 23 20 17 17 14 10 5 7 10
 9 10 6 5 1 1 3 4 9 10 14 18 18 15 15 7 8 9 11 11 9 11 7 8 4 1 1 -3 -3 -4 -6 -9 -5 -13 -13 -16 -8 -9 -4 -5 -8 -4 -3 -4 0 -6 -7 -8 -9 35 32 29 30 28 25 28 26 29 21 25 23 25 24 19 19 17 17 17 19 18 21 19 20 16 18 14 16 16 17 20 19 20 23 18 20 28 25 24 25 28 27 23 25 20 18 14 7 8 9 11
 11 5 0 0 -3 -4 -4 -7 -2 -5 -7 -14 -11 -5 -7 -11 -12 -12 -8 -5 -3 1 -4 -2 -1 -5 -8 -9 -13 -19 -21 -22 -28 -30 -36 -40 -45 -45 -48 -48 -40 -39 -37 -33 -27 -31 -27 -29 -20 34 25 23 18 20 16 14 13 16 13 9 11 8 11 11 14 15 9 12 17 15 18 17 23 20 17 16 13 15 5 7 7 8 2 5 2 2 -2 0 0 0 4 9 12 11 15 14 15 15 4 10
 7 5 -1 -6 -7 -4 -7 -6 -3 -4 -4 -8 -7 -2 -7 -15 -15 -12 -7 -2 0 -4 -7 -6 -2 -4 -7 -9 -13 -16 -19 -20 -25 -36 -34 -38 -40 -44 -46 -42 -38 -40 -38 -37 -34 -33 -31 -30 -21 23 21 21 20 20 18 19 17 15 15 9 10 13 17 19 17 19 16 17 20 19 16 22 25 22 16 15 14 9 5 7 7 7 6 5 3 2 2 3 0 2 4 8 12 12 15 11 13 15 11 10
 6 2 0 -6 -9 -12 -1 -3 -2 -3 -3 -7 -13 -8 -9 -10 -16 -10 -8 -7 -3 -1 -4 -5 -3 -3 -3 -6 -11 -13 -23 -24 -29 -35 -34 -38 -42 -42 -43 -41 -39 -44 -42 -36 -34 -33 -31 -28 -12 24 23 22 20 21 24 22 20 21 15 11 7 13 15 24 19 23 15 19 21 18 17 21 23 23 16 14 16 15 10 11 9 9 5 7 3 0 3 1 3 4 5 9 14 15 18 14 7 14 8 9
 5 -2 -8 -10 -10 -17 -3 -1 -1 -3 -10 -10 -15 -11 -14 -15 -12 -13 -14 -11 -8 -3 -5 -5 3 -1 -4 -6 -13 -25 -24 -26 -34 -34 -32 -31 -39 -35 -39 -44 -41 -41 -38 -40 -38 -33 -24 -14 -9 22 20 25 24 25 29 28 29 27 20 16 7 19 20 26 23 16 18 18 17 18 17 16 19 19 15 15 14 14 12 12 14 9 3 3 2 2 3 7 3 2 9 12 16 16 15 7 6 6 3 7
 2 -3 -6 -8 -9 -11 -7 -3 -6 -10 -12 -10 -12 -9 -11 -13 -11 -13 -13 -13 -13 -9 -8 -9 0 -1 0 -9 -12 -15 -20 -21 -23 -27 -29 -31 -27 -32 -34 -40 -38 -43 -42 -44 -35 -29 -19 -12 -9 18 20 22 26 27 33 32 27 27 17 16 10 16 19 16 17 14 16 20 19 17 18 19 18 20 15 17 17 14 14 15 13 11 9 8 5 1 5 10 5 6 9 9 15 15 11 3 3 4 4 5
 5 -1 -7 -13 -12 -18 -14 -9 -12 -12 -11 -11 -16 -14 -14 -12 -15 -13 -18 -16 -13 -12 -10 -10 0 -2 -2 -6 -6 -10 -16 -17 -21 -25 -25 -29 -20 -28 -34 -38 -43 -51 -42 -40 -37 -29 -20 -14 -13 11 18 19 28 32 35 39 29 28 21 17 13 13 16 18 16 18 22 22 20 19 21 19 18 18 14 13 11 16 15 21 15 15 16 11 8 6 3 7 4 3 9 10 12 9 3 3 0 0 5 1
 6 -3 -6 -14 -13 -18 -21 -12 -14 -12 -7 -7 -16 -10 -15 -17 -16 -17 -16 -18 -18 -17 -14 -15 0 -5 -4 -8 -8 -10 -12 -16 -14 -16 -16 -22 -19 -29 -35 -36 -37 -40 -41 -29 -28 -20 -17 -17 -13 10 14 21 20 26 36 36 26 23 20 12 11 13 11 11 13 18 21 23 22 22 17 18 13 13 10 11 15 13 17 18 19 12 12 9 5 0 5 10 8 12 12 13 10 7 4 4 0 1 4 1
 2 -1 -8 -14 -10 -12 -8 -9 -7 -6 -3 -5 -7 -6 -12 -19 -21 -20 -21 -24 -23 -19 -17 -12 -3 -5 -7 -2 -2 -4 -12 -14 -11 -11 -10 -16 -22 -28 -33 -26 -28 -33 -29 -24 -20 -17 -18 -19 -12 6 8 12 14 20 24 24 21 19 12 10 9 12 10 14 16 18 20 18 20 19 18 14 11 14 11 12 12 17 21 22 11 9 8 4 4 3 8 10 10 12 12 13 8 6 6 5 3 -1 3 6
 5 -5 -9 -9 -9 -11 -9 -6 -7 -2 -2 -4 -5 -8 -12 -18 -25 -25 -25 -26 -25 -20 -18 -16 0 1 0 -1 -1 -4 -5 -7 -8 -4 -6 -15 -19 -24 -26 -27 -29 -27 -19 -21 -13 -15 -12 -17 -14 0 3 5 10 15 25 22 19 11 11 6 2 11 12 11 14 15 25 16 15 17 15 13 12 14 11 12 17 14 16 23 10 6 3 4 4 6 12 10 15 12 11 10 8 8 6 7 0 1 3 4
 0 -5 -9 -8 -2 -2 -3 -1 -2 -4 -4 -3 -8 -12 -16 -22 -23 -27 -27 -28 -26 -24 -18 -16 2 -2 0 0 -6 -9 -3 -3 2 -3 -9 -10 -15 -14 -18 -23 -19 -22 -19 -16 -11 -13 -14 -12 -13 0 -4 0 3 7 13 19 11 8 9 13 12 13 14 17 15 15 17 14 12 14 12 10 10 9 12 7 9 13 9 17 11 5 1 3 9 8 14 16 12 11 10 11 11 8 7 4 3 11 9 5
 -1 -2 -5 0 -2 3 2 0 2 -1 -3 -2 -7 -13 -18 -22 -20 -27 -32 -31 -28 -24 -20 -21 0 -4 -2 -3 -6 -6 -4 -2 -2 -7 -11 -11 -8 -6 -8 -12 -12 -17 -16 -17 -15 -13 -13 -11 -7 -7 -6 -4 2 7 10 7 9 10 13 16 14 9 9 10 13 12 12 9 10 9 11 10 11 8 2 0 3 6 6 8 7 5 5 10 14 12 13 15 13 10 9 13 9 7 3 4 8 14 10 6
 -3 0 -1 -1 0 4 4 4 8 0 0 -3 -6 -11 -15 -23 -22 -30 -32 -30 -30 -23 -23 -25 -1 -3 -3 -3 -7 -5 -6 -2 0 -8 -9 -10 -8 -2 -7 -7 -7 -10 -13 -16 -16 -14 -5 -13 -9 -8 -7 -6 -5 4 4 5 4 8 12 15 11 8 8 10 6 10 8 5 6 9 5 11 4 7 -1 1 0 2 5 9 8 4 6 11 15 13 11 13 10 10 9 8 11 6 2 5 7 8 4 5
 2 1 1 0 -1 1 8 -2 1 -1 -1 -2 -7 -9 -12 -12 -14 -12 -13 -15 -15 -15 -22 -25 -5 -3 0 -1 0 3 8 3 1 1 -3 0 -3 -4 -9 -5 -5 -5 -7 -11 -15 -11 -10 -9 -5 -10 -5 -7 -10 -4 0 1 3 5 3 5 9 7 3 0 0 5 3 0 -2 0 0 -2 -3 0 3 -3 -2 -2 0 -2 -3 0 0 6 9 12 13 13 14 12 12 8 4 1 3 6 7 9 4 2
 1 -1 -4 -6 -9 -2 -7 -8 -8 -4 -3 -5 -9 -10 -15 -17 -17 -18 -15 -14 -14 -22 -24 -24 -1 -3 0 1 0 6 9 6 4 1 -3 -1 -7 -6 -8 -5 -3 -6 -7 -7 -10 -7 -6 -8 -5 -5 -4 -8 -4 -2 0 -2 0 1 -1 1 1 3 4 0 6 12 7 -5 -6 -4 -2 -4 -5 -3 -1 -3 -3 -4 -1 0 -1 -2 4 10 13 13 12 12 11 12 16 11 5 5 4 6 9 10 2 0
 2 -2 -6 -15 -10 -6 -13 -8 -10 -7 -9 -8 -2 -9 -15 -18 -18 -19 -17 -18 -18 -21 -24 -26 -1 0 -1 6 4 6 13 10 7 4 0 -1 -12 -11 -10 -13 -5 -7 -8 -6 -6 -7 -9 -7 -2 -4 -4 -8 -6 -3 -5 -2 -2 2 -5 -1 -1 2 3 5 3 8 4 -7 -10 -7 -2 -3 -4 -6 -4 -3 -3 -4 -3 -4 -2 2 8 11 11 16 10 9 5 4 10 7 9 3 9 8 12 9 4 0
 0 -6 -11 -12 -11 -10 -12 -12 -9 -12 -8 -7 -5 -9 -10 -18 -19 -16 -21 -19 -19 -23 -22 -23 1 4 6 8 13 13 16 11 10 7 2 2 -10 -14 -17 -13 -11 -11 -6 -6 -3 -6 -7 -2 -2 -3 -3 -8 -3 -5 -2 -1 -7 -11 -7 -9 -10 3 0 1 2 3 5 -9 -8 -6 -1 -7 -9 -10 -4 -3 0 -4 -3 -5 2 4 5 10 12 13 7 5 4 6 9 14 5 4 8 8 9 6 5 2
 -1 -3 -6 -10 -11 -10 -14 -12 -13 -10 -7 -5 -3 -4 -7 -15 -18 -22 -19 -20 -24 -21 -17 -18 4 6 8 12 13 11 15 13 13 5 2 2 -11 -13 -16 -9 -9 -7 -7 -5 -6 -5 -5 0 1 0 -1 -2 -3 -8 -7 -10 -13 -12 -13 -15 -13 -2 -3 -3 0 0 3 -6 -7 -6 -3 -7 -9 -8 -8 -5 -6 -3 0 0 2 5 8 16 17 16 5 5 6 8 11 15 7 5 5 8 6 8 5 6
 -1 -3 -6 -9 -12 -16 -21 -16 -19 -8 -5 -9 3 3 0 -12 -16 -20 -21 -22 -24 -23 -20 -22 7 6 10 14 15 17 12 14 11 9 4 0 -9 -12 -9 -10 -8 -10 -8 -6 -9 -5 -6 0 -2 7 4 3 -1 -3 0 -13 -15 -14 -15 -17 -19 -8 -3 -1 -1 -3 1 -9 -10 -5 -3 -9 -8 -10 -13 -12 -11 -3 0 1 4 8 8 14 18 19 2 4 8 10 10 16 11 6 10 8 11 9 6 6
 -2 -10 -11 -14 -16 -17 -20 -19 -13 -12 -4 -4 7 0 0 -2 -9 -9 -20 -15 -20 -22 -13 -13 6 10 11 15 13 13 14 6 8 5 -3 0 -10 -7 -4 -4 -6 -9 -9 -7 -3 -5 0 4 1 10 8 3 -1 -7 -12 -16 -22 -23 -26 -23 -24 -10 -6 -10 -8 -7 -6 -7 -10 -16 -19 -16 -18 -13 -18 -17 -16 -12 -9 -5 3 2 3 6 8 9 2 5 10 9 10 13 10 4 7 4 7 5 4 6
 -6 -9 -11 -13 -20 -19 -17 -17 -16 -6 -3 0 4 2 4 0 -4 -10 -10 -10 -16 -14 -9 -9 7 11 10 9 12 10 3 -2 0 -5 -8 -5 -10 -7 -7 -9 -5 -10 -11 -10 -8 -6 -1 5 4 5 5 0 -6 -7 -12 -20 -23 -28 -27 -23 -23 -11 -8 -9 -12 -12 -10 -12 -13 -18 -25 -24 -20 -18 -17 -16 -15 -12 -11 -9 0 2 3 6 5 8 6 9 9 10 10 9 4 2 3 3 5 6 7 6
 -2 -7 -5 -14 -17 -18 -15 -13 -11 -3 0 3 7 6 5 1 -4 -3 -6 -11 -10 -16 -8 -8 3 5 3 5 8 6 0 -4 -3 -8 -6 -7 -15 -15 -10 -13 -12 -11 -15 -13 -9 -9 -2 2 1 2 2 -2 -8 -8 -12 -23 -26 -29 -29 -25 -20 -19 -12 -12 -13 -14 -11 -17 -24 -24 -31 -28 -23 -20 -17 -16 -17 -18 -13 -5 -1 0 2 5 6 7 9 12 12 11 9 11 5 3 1 1 3 5 0 3
 -2 -4 -5 -11 -13 -16 -9 -8 -7 -2 0 1 8 8 9 3 1 -1 -8 -12 -13 -11 -10 -6 2 0 2 4 5 5 -4 -6 -9 -9 -9 -11 -17 -17 -16 -15 -14 -16 -16 -17 -13 -13 -9 -5 0 -1 -2 -4 -8 -11 -11 -22 -26 -29 -26 -25 -19 -16 -17 -15 -16 -16 -14 -25 -28 -31 -33 -32 -29 -23 -18 -17 -16 -14 -13 -13 -4 -1 1 7 7 8 6 8 11 7 5 4 3 1 0 0 -3 -2 1 3
 1 -1 1 -6 -9 -10 -3 -7 0 1 0 4 10 8 3 2 4 -4 -4 -4 -13 -9 -5 -5 -8 0 0 1 5 2 -10 -12 -10 -18 -15 -15 -24 -19 -16 -17 -19 -18 -17 -16 -15 -12 -10 -8 -5 -1 -7 -4 -10 -11 -14 -20 -25 -25 -22 -30 -25 -19 -21 -23 -22 -23 -22 -25 -30 -31 -31 -34 -29 -28 -20 -18 -19 -14 -15 -11 -4 -2 4 4 4 8 8 10 5 4 2 2 2 1 2 -2 0 0 -2 1
 1 1 -1 -4 -6 -6 -4 -4 -1 3 4 9 13 11 10 6 5 5 2 0 -5 -3 -1 -4 -6 -5 -3 1 1 -1 -18 -19 -17 -20 -22 -22 -23 -23 -19 -22 -23 -19 -13 -13 -14 -12 -11 -10 -4 -5 -5 -14 -12 -11 -13 -23 -23 -22 -32 -33 -32 -25 -25 -25 -30 -30 -26 -31 -30 -32 -31 -28 -28 -25 -20 -20 -20 -15 -12 -13 -5 -2 -1 1 1 2 10 14 7 0 -1 -4 0 0 -1 -4 0 2 1 -1
 1 2 1 -6 -2 -2 -1 0 6 5 8 14 14 16 14 15 10 4 7 2 -2 -4 -5 -2 -9 -8 -9 -6 -5 -6 -18 -17 -24 -22 -23 -30 -23 -25 -21 -22 -23 -19 -17 -14 -17 -13 -11 -13 -9 -8 -7 -18 -15 -16 -19 -21 -26 -23 -28 -32 -34 -30 -29 -33 -35 -31 -32 -34 -31 -34 -35 -31 -32 -30 -31 -23 -27 -16 -14 -16 -9 -5 -7 0 1 2 6 6 5 -2 -5 -5 -5 -2 0 -4 -8 0 3 0
 0 0 1 2 0 3 4 6 6 9 13 13 19 19 17 13 12 13 9 5 1 -3 -7 -9 -13 -13 -14 -17 -17 -18 -16 -17 -22 -27 -27 -27 -28 -27 -23 -19 -19 -18 -16 -13 -12 -14 -15 -12 -9 -11 -13 -19 -22 -21 -22 -25 -27 -25 -27 -29 -30 -32 -33 -34 -32 -33 -33 -33 -33 -35 -36 -32 -34 -32 -28 -25 -22 -21 -17 -14 -11 -8 -6 -1 1 2 1 0 -4 -5 -7 -6 -3 -3 -1 -1 1 2 1 0
