 0 0 0 0 0 0 -1 -1 -2 -2 -2 -1 -2 -2 -3 -3 -4 -6 -7 -6 -6 -6 -7 -7 -8 -7 -8 -7 -7 -8 -9 -9 -10 -10 -10 -12 -12 -11 -11 -11 -11 -12 -12 -12 -12 -13 -14 -14 -15 -15 -15 -14 -14 -13 -13 -12 -11 -11 -10 -10 -11 -11 -10 -10 -10 -9 -9 -8 -7 -6 -5 -5 -6 -6 -6 -5 -6 -6 -6 -6 -6 -4 -5 -4 -5 -5 -6 -5 -5 -5 -4 -3 -3 -2 -1 -2 -2 -1 -1 0
 1 0 0 0 0 0 -1 -1 -2 0 -1 -1 -1 -2 -3 -3 -3 -5 -6 -5 -5 -6 -6 -7 -7 -7 -6 -6 -6 -8 -9 -9 -9 -9 -10 -10 -10 -10 -10 -9 -9 -11 -11 -11 -12 -13 -14 -14 -14 -14 -14 -14 -12 -12 -12 -9 -9 -9 -8 -9 -10 -10 -9 -9 -8 -9 -8 -7 -6 -6 -4 -6 -6 -6 -4 -4 -5 -5 -5 -4 -3 -4 -4 -4 -5 -5 -4 -3 -4 -3 -3 -3 -3 -2 -2 -2 -1 -1 -1 -1
 1 1 1 0 1 0 0 0 0 -1 0 -1 -1 -1 -2 -3 -3 -4 -6 -5 -5 -6 -6 -6 -7 -6 -7 -6 -7 -7 -8 -9 -8 -9 -9 -10 -10 -10 -10 -9 -10 -10 -12 -11 -11 -13 -13 -14 -14 -13 -12 -12 -11 -10 -10 -8 -8 -8 -7 -8 -8 -9 -8 -8 -8 -8 -8 -6 -5 -5 -4 -5 -5 -5 -5 -4 -4 -4 -4 -3 -2 -2 -3 -3 -4 -5 -4 -2 -3 -2 -3 -2 -3 -3 -3 -3 -3 -2 -2 -2
 1 1 2 1 2 1 1 1 0 0 0 0 -1 -1 -2 -3 -3 -3 -5 -4 -5 -5 -5 -6 -6 -5 -4 -6 -6 -7 -7 -7 -7 -8 -7 -7 -9 -8 -8 -9 -9 -9 -11 -12 -13 -12 -14 -14 -15 -12 -10 -10 -9 -8 -8 -8 -6 -6 -6 -6 -6 -8 -7 -7 -7 -7 -7 -5 -4 -3 -3 -3 -3 -3 -4 -3 -3 -3 -1 -1 -1 -1 -1 -2 -3 -3 -3 -2 -2 -2 -2 -2 -4 -3 -3 -3 -3 -3 -3 -4
 2 2 2 2 3 2 2 2 1 0 1 0 0 0 -1 -2 -3 -3 -4 -4 -4 -4 -5 -6 -5 -5 -5 -6 -6 -6 -6 -7 -7 -6 -6 -7 -8 -8 -7 -8 -8 -9 -11 -12 -12 -12 -13 -14 -15 -10 -10 -9 -8 -7 -7 -5 -5 -5 -5 -5 -6 -6 -6 -6 -6 -7 -6 -4 -4 -3 -2 -3 -3 -3 -2 -2 -2 -1 -1 0 0 0 0 -1 -2 -2 -3 -3 -2 -2 -3 -2 -3 -4 -3 -3 -3 -3 -4 -4
 3 3 3 3 3 3 3 2 1 1 1 1 -1 0 -1 -3 -2 -3 -3 -3 -4 -5 -5 -6 -5 -4 -4 -5 -6 -6 -6 -6 -6 -6 -5 -6 -7 -7 -7 -7 -8 -9 -10 -11 -12 -12 -14 -14 -14 -9 -9 -9 -7 -6 -6 -5 -5 -4 -4 -4 -4 -6 -6 -5 -5 -6 -5 -4 -4 -3 -3 -3 -2 -2 0 -1 -1 0 0 0 0 0 0 -1 -1 -3 -2 -2 -3 -1 -2 -2 -3 -3 -3 -3 -4 -4 -4 -5
 4 4 4 4 5 4 3 3 3 2 2 2 0 -1 -1 -1 -3 -3 -4 -4 -4 -4 -3 -4 -3 -3 -2 -3 -4 -5 -5 -4 -4 -4 -3 -4 -7 -7 -7 -7 -7 -7 -9 -11 -12 -12 -13 -13 -14 -9 -8 -7 -7 -5 -5 -4 -3 -4 -3 -4 -4 -5 -4 -4 -4 -5 -5 -4 -3 -3 -2 -1 -1 -1 0 1 1 1 1 2 1 0 0 -1 -2 -1 -2 -2 -2 -2 -1 -2 -3 -4 -4 -5 -5 -5 -6 -6
 5 5 5 5 5 5 4 4 3 2 2 2 0 -2 -1 -1 -2 -3 -3 -3 -3 -3 -3 -4 -2 -2 -2 -2 -2 -4 -3 -3 -3 -3 -3 -3 -5 -6 -6 -6 -7 -7 -9 -10 -11 -11 -12 -12 -13 -8 -7 -7 -6 -5 -4 -4 -4 -3 -3 -4 -3 -3 -3 -4 -4 -4 -4 -2 -3 -2 -2 -1 0 0 1 2 1 1 2 2 0 0 -1 -1 -1 -1 -1 -1 -1 -1 -1 -2 -4 -4 -4 -5 -5 -5 -5 -6
 5 6 6 6 5 4 4 4 3 2 2 2 0 -1 -1 -2 -2 -3 -3 -3 -3 -3 -3 -4 -2 -2 -2 -1 -1 -3 -3 -3 -3 -2 -2 -2 -5 -6 -6 -5 -6 -7 -9 -9 -10 -11 -11 -12 -13 -8 -7 -7 -5 -4 -4 -3 -3 -3 -2 -2 -2 -3 -3 -4 -4 -3 -3 -1 -1 -2 -1 -1 0 0 2 2 1 1 2 3 0 0 -1 -1 -1 -1 -1 0 -1 -1 -1 -2 -5 -4 -4 -5 -4 -4 -5 -5
 6 7 7 6 5 5 4 4 3 3 2 3 0 0 0 -1 -1 -2 -4 -3 -3 -3 -3 -4 -2 -1 -1 -1 -1 -1 -2 -1 0 -1 -1 -2 -5 -4 -4 -5 -5 -6 -8 -9 -9 -10 -11 -13 -13 -8 -6 -5 -5 -4 -3 -3 -2 -3 -2 -1 0 -2 -2 -3 -3 -2 -1 -1 0 0 0 0 0 1 1 1 1 1 2 2 0 0 0 -1 0 0 0 0 -1 -2 -3 -3 -4 -4 -4 -4 -4 -4 -4 -5
 8 7 7 6 5 5 5 4 4 3 3 3 1 0 0 0 0 -2 -2 -2 -3 -3 -4 -3 0 0 0 0 -1 -1 0 0 -1 -1 -1 -1 -3 -3 -3 -4 -5 -5 -7 -8 -9 -9 -11 -13 -14 -6 -6 -6 -4 -3 -3 -2 -2 -2 -1 0 0 -1 -1 -2 -1 -1 -1 0 0 0 0 0 1 1 2 1 1 2 2 2 0 0 0 0 0 0 0 0 -1 -3 -4 -4 -4 -5 -4 -4 -4 -4 -5 -4
 7 7 7 6 6 6 5 5 4 4 3 3 2 1 0 -1 0 -1 -2 -3 -3 -3 -3 -4 0 0 0 0 0 0 0 0 0 0 0 0 -3 -3 -3 -4 -5 -5 -7 -8 -9 -9 -11 -13 -13 -6 -6 -6 -4 -4 -3 -2 -1 -2 0 0 0 0 -1 -1 0 -1 0 0 0 0 0 0 1 2 3 2 2 1 1 2 1 0 0 0 0 0 0 0 -1 -2 -4 -4 -5 -4 -4 -5 -5 -4 -5 -5
 8 8 8 7 8 8 7 7 7 6 4 4 2 2 3 2 1 2 1 0 0 0 -1 -2 0 0 0 0 0 0 -1 -1 0 0 -1 0 -1 -3 -4 -4 -7 -8 -8 -11 -12 -13 -13 -14 -15 -7 -5 -5 -4 -4 -2 -2 0 0 0 0 1 0 1 1 1 2 3 3 4 3 4 5 4 4 3 3 2 2 2 1 1 2 1 1 2 2 0 0 0 0 -1 -2 -3 -3 -3 -2 -3 -3 -4 -4
 9 8 8 8 8 8 8 7 6 5 3 3 2 1 2 1 1 2 1 0 0 0 0 -1 1 1 0 0 0 -1 -1 -1 -1 -1 -1 -1 -3 -4 -4 -7 -8 -8 -10 -11 -12 -13 -13 -14 -14 -5 -4 -4 -4 -4 -3 0 0 0 1 0 0 1 1 2 3 3 3 4 4 5 5 5 5 5 4 4 3 3 3 2 4 4 3 3 3 2 1 0 0 0 0 -1 -2 -2 -2 -2 -3 -3 -3 -4
 8 8 8 8 9 9 8 8 7 5 4 4 2 2 2 2 2 1 1 1 1 0 0 -1 1 1 1 0 0 -1 -1 -1 -2 -1 -1 -1 -4 -5 -5 -7 -8 -9 -11 -11 -12 -13 -15 -14 -14 -5 -5 -3 -3 -3 -1 0 1 2 2 1 2 2 2 3 4 3 3 4 4 3 5 6 6 6 5 5 3 5 4 3 4 4 3 4 3 3 1 1 0 1 0 -1 -2 -2 -2 -2 -1 -2 -3 -3
 8 9 9 9 9 9 8 7 6 6 4 4 2 2 3 2 2 1 1 1 1 0 0 0 2 1 1 0 0 -1 -1 -1 -1 -1 -2 -2 -4 -5 -6 -8 -10 -11 -11 -13 -14 -14 -14 -15 -15 -6 -4 -4 -2 -1 0 1 2 3 3 3 3 2 3 3 4 4 4 5 5 5 7 7 8 8 6 5 6 6 6 6 5 5 5 4 4 3 2 2 2 1 0 0 -1 -1 -1 -1 -1 -2 -2 -2
 10 10 10 10 10 9 8 7 7 6 5 4 2 1 2 2 2 1 2 1 2 1 0 0 2 2 1 0 0 0 -1 -1 -1 -2 -3 -3 -4 -5 -6 -9 -10 -11 -13 -14 -14 -14 -15 -15 -15 -6 -5 -4 -1 -1 0 1 2 2 3 3 3 4 4 4 4 4 4 5 6 6 7 7 8 8 7 6 7 8 8 7 7 7 6 6 5 4 4 3 3 2 1 0 0 0 -1 0 -1 -1 -1 -2
 11 11 10 11 11 10 9 8 7 6 5 4 1 2 3 2 2 2 1 2 1 1 0 0 3 2 1 1 0 0 0 -1 -1 -2 -3 -3 -5 -5 -7 -10 -11 -12 -13 -14 -14 -15 -14 -15 -16 -6 -5 -4 -1 -1 0 1 1 2 3 3 5 3 4 4 5 4 4 6 7 8 8 8 8 9 9 8 9 9 9 8 7 7 7 6 5 4 5 4 3 2 2 0 0 0 0 0 -1 -1 -1 -1
 11 10 10 10 10 10 10 8 8 6 4 4 3 3 3 3 3 2 2 3 2 2 2 1 3 2 1 0 0 0 0 -2 -3 -4 -4 -5 -5 -8 -8 -10 -11 -13 -14 -14 -14 -14 -14 -15 -15 -6 -4 -2 -1 0 1 1 1 2 3 4 4 3 5 5 5 5 6 7 8 8 9 9 10 10 11 11 11 11 10 10 8 8 7 7 7 6 6 5 4 4 2 1 0 0 0 0 0 0 -1 0
 10 9 10 9 9 10 8 8 7 5 5 4 3 3 3 3 3 2 4 5 3 3 2 2 3 3 1 0 0 0 -2 -3 -3 -5 -4 -5 -6 -8 -9 -10 -11 -12 -13 -13 -13 -13 -14 -15 -16 -4 -4 -2 0 0 0 1 1 2 3 5 5 5 5 5 6 6 6 8 8 9 10 10 10 11 12 12 12 12 12 11 9 9 9 9 8 7 6 5 5 4 3 2 0 0 0 0 0 0 -1 0
 10 9 10 9 9 9 8 8 7 6 5 5 3 3 3 4 3 3 4 4 4 3 3 3 4 3 1 0 0 0 -2 -3 -4 -5 -5 -6 -6 -7 -9 -11 -11 -11 -13 -13 -13 -13 -14 -15 -15 -4 -3 -1 -1 0 0 0 1 2 4 5 6 5 5 6 6 7 7 8 8 10 11 11 11 13 13 13 12 12 12 11 10 10 10 10 8 7 7 6 6 5 4 2 1 0 0 0 0 0 0 0
 10 9 9 9 8 9 8 7 6 6 5 4 3 3 3 3 5 6 5 5 5 4 4 4 4 2 1 0 0 -1 -2 -4 -4 -5 -5 -5 -6 -8 -8 -10 -11 -12 -13 -13 -13 -13 -13 -14 -15 -3 -2 -2 0 0 1 1 1 1 4 5 5 5 6 7 7 8 9 9 10 11 11 12 13 15 14 14 13 13 12 11 11 11 11 10 9 8 8 7 7 5 5 3 1 1 1 0 1 0 0 0
 10 10 9 9 8 8 7 6 6 5 4 4 4 4 4 4 5 6 6 6 5 5 5 5 4 3 2 0 0 0 -2 -3 -4 -5 -5 -6 -7 -8 -8 -10 -10 -11 -13 -13 -12 -12 -13 -14 -15 -3 -2 -1 0 1 1 1 1 2 4 5 6 6 7 8 8 8 9 11 12 12 12 13 13 15 15 14 14 13 12 13 11 11 11 9 9 9 8 7 7 6 5 5 3 3 2 1 1 0 0 0
 10 10 9 9 8 8 7 7 6 5 4 4 4 4 5 5 5 6 6 6 6 6 5 5 4 4 3 1 0 0 -2 -3 -5 -5 -5 -6 -7 -8 -9 -10 -10 -11 -12 -12 -13 -13 -13 -14 -14 -3 -2 -2 0 0 1 1 2 3 4 5 5 7 7 9 9 10 10 12 12 12 13 14 15 16 16 15 15 13 13 13 12 12 11 10 10 10 9 8 7 7 6 4 4 3 3 2 1 1 0 0
 10 10 9 9 9 9 9 8 9 9 9 8 8 8 8 8 8 8 7 7 7 7 7 6 5 4 4 3 2 2 1 0 0 0 -2 -3 -3 -5 -6 -7 -8 -10 -11 -12 -14 -14 -14 -15 -15 -3 -2 -2 -1 0 0 0 1 2 2 3 3 5 7 7 8 10 10 12 13 14 14 15 16 17 17 15 15 14 13 14 13 10 9 9 7 7 6 6 5 6 6 6 6 4 4 3 2 1 0 0
 10 10 10 9 9 9 9 9 8 8 8 8 8 8 8 8 8 8 7 7 7 7 7 6 3 3 3 2 2 2 1 1 0 -1 -2 -2 -4 -5 -6 -8 -9 -10 -12 -12 -13 -14 -15 -15 -16 -3 -2 -2 -1 -1 0 0 0 1 1 2 3 6 8 8 9 10 11 12 13 14 14 14 15 16 16 15 14 13 13 13 11 10 10 8 7 7 7 7 7 7 6 6 5 4 4 3 2 1 1 0
 10 10 10 10 10 10 9 9 8 8 8 7 7 7 8 9 8 7 8 8 7 7 7 6 3 3 3 3 2 2 1 0 0 0 -1 -2 -4 -5 -6 -9 -10 -11 -12 -13 -13 -14 -14 -14 -15 -3 -2 -1 -1 -1 0 -1 0 0 1 1 3 6 7 7 9 9 10 12 13 13 14 14 15 17 15 14 13 12 13 12 11 10 10 9 8 8 8 8 7 7 7 7 5 5 3 3 2 1 1 0
 10 10 10 10 9 9 10 9 8 8 7 7 7 8 8 8 7 8 8 8 7 7 7 6 3 3 4 3 4 3 1 0 0 -1 -2 -4 -5 -7 -7 -9 -12 -13 -14 -14 -14 -15 -15 -16 -16 -4 -3 -3 -2 -1 -2 -1 -2 -1 0 1 1 5 6 7 8 8 10 12 12 13 13 14 15 16 14 13 13 12 11 10 11 10 9 9 8 7 9 10 10 8 9 9 6 5 5 5 4 3 2 1
 10 10 10 10 10 9 9 8 8 8 7 6 7 8 9 8 8 8 8 8 8 7 7 7 3 4 3 4 4 4 1 0 0 -2 -2 -3 -6 -8 -8 -11 -12 -13 -14 -15 -15 -15 -15 -15 -16 -4 -4 -3 -3 -2 -2 -3 -3 -2 0 0 0 4 5 6 7 8 9 11 12 13 13 14 15 16 14 13 12 11 11 10 9 9 9 8 8 8 11 11 10 10 9 9 7 6 6 6 4 4 2 1
 10 10 10 10 10 9 9 8 8 7 6 5 6 8 7 8 8 9 8 8 7 7 7 7 3 4 4 5 5 4 2 1 0 -2 -3 -3 -6 -8 -8 -11 -12 -13 -14 -15 -15 -15 -15 -15 -16 -5 -5 -4 -4 -4 -4 -4 -4 -2 -1 0 0 3 4 5 6 7 8 11 12 12 13 14 15 15 13 13 13 10 11 10 9 9 10 8 8 7 11 11 12 11 11 11 8 7 7 6 6 5 2 1
 11 11 11 10 10 11 9 7 7 6 6 6 6 7 8 7 8 8 8 8 8 7 6 6 3 4 4 3 4 4 3 0 -1 -1 -4 -5 -6 -8 -9 -11 -13 -14 -15 -14 -14 -13 -13 -14 -14 -6 -6 -6 -6 -5 -4 -4 -4 -3 -3 -1 -1 3 4 4 6 6 7 10 11 12 12 13 13 14 13 12 11 12 10 8 9 9 9 9 10 10 12 11 11 11 11 11 9 6 6 4 4 3 2 1
 11 11 11 11 11 10 9 7 7 7 6 6 7 8 7 7 8 8 8 8 8 7 6 6 4 4 3 2 3 3 0 -1 -1 -4 -5 -6 -8 -8 -9 -12 -12 -13 -14 -14 -14 -13 -13 -13 -14 -7 -7 -6 -5 -5 -4 -4 -3 -3 -2 -1 0 2 3 4 5 5 6 9 11 11 12 13 13 14 11 11 12 10 9 9 9 9 10 10 11 10 12 11 11 11 10 10 7 6 4 4 4 3 2 1
 12 11 11 10 11 10 8 8 8 6 6 6 6 7 6 7 8 7 8 7 7 6 6 5 3 4 2 1 2 2 0 -2 -3 -4 -6 -6 -8 -9 -10 -11 -12 -13 -13 -14 -14 -13 -13 -13 -14 -7 -7 -7 -5 -5 -5 -4 -4 -4 -3 -2 -1 1 3 4 4 5 6 9 10 11 11 10 13 14 11 11 11 9 9 9 8 10 9 10 10 11 12 12 12 11 10 9 7 6 4 4 2 3 2 1
 11 11 11 11 10 10 9 9 7 7 7 6 6 6 7 7 8 8 7 7 7 6 6 6 3 2 1 0 0 0 -1 -4 -4 -6 -7 -7 -8 -10 -10 -11 -12 -13 -14 -13 -13 -13 -13 -12 -13 -7 -7 -6 -6 -5 -5 -5 -5 -4 -3 -3 -2 1 1 2 4 5 5 9 9 9 10 10 11 13 10 10 11 10 9 9 9 9 9 10 10 11 12 12 11 11 9 7 6 5 4 3 3 3 2 1
 12 12 11 10 9 10 10 9 8 7 7 6 6 6 7 7 7 7 7 7 7 7 7 6 2 1 0 0 0 0 -3 -3 -4 -6 -7 -8 -9 -10 -10 -11 -12 -12 -13 -13 -13 -13 -12 -12 -13 -8 -8 -7 -5 -5 -5 -5 -5 -5 -4 -3 -2 0 0 1 3 4 4 7 8 9 10 10 11 13 10 10 10 10 10 9 9 9 9 11 11 11 11 11 11 9 8 7 5 4 4 3 3 3 2 1
 12 12 12 11 11 11 9 9 8 7 7 6 6 7 7 7 7 7 7 7 7 7 6 6 1 0 0 0 -1 -2 -4 -4 -4 -7 -8 -8 -9 -10 -10 -11 -11 -12 -13 -13 -12 -12 -13 -12 -13 -7 -7 -7 -5 -5 -5 -4 -5 -5 -4 -4 -3 -1 -1 0 2 3 3 6 7 8 9 10 11 12 10 9 10 9 9 9 10 9 10 10 11 11 11 10 9 8 7 6 5 4 4 3 3 2 1 1
 13 12 12 11 10 10 9 9 8 7 6 6 6 7 7 8 7 8 8 7 7 6 6 6 1 0 0 -1 -2 -3 -3 -4 -5 -5 -7 -8 -9 -9 -9 -8 -9 -9 -9 -10 -10 -10 -11 -11 -12 -7 -7 -7 -6 -6 -6 -6 -5 -5 -5 -4 -4 -3 -1 0 0 0 0 2 5 6 8 9 10 11 9 9 9 8 8 8 8 8 9 9 10 11 11 8 8 7 6 4 5 4 3 2 2 2 1 1
 12 12 12 11 10 9 9 9 8 7 6 6 7 8 8 8 7 8 7 6 6 6 5 5 0 0 0 -2 -2 -3 -3 -4 -4 -5 -6 -7 -8 -9 -9 -8 -9 -9 -8 -9 -10 -10 -10 -11 -12 -7 -7 -6 -7 -6 -6 -6 -5 -5 -5 -4 -4 -2 -1 -1 0 0 0 2 4 6 7 9 10 11 9 8 8 7 7 7 7 8 8 8 9 10 8 7 7 6 5 5 4 3 3 2 2 2 1 1
 13 12 12 11 10 10 9 9 8 7 6 6 8 8 9 9 8 8 7 7 7 6 5 5 0 0 0 -1 -2 -2 -3 -4 -4 -5 -5 -6 -7 -8 -8 -8 -8 -9 -8 -9 -10 -9 -10 -11 -12 -7 -7 -7 -6 -6 -6 -7 -6 -6 -5 -4 -3 -2 -2 -1 0 0 0 2 4 5 7 8 9 10 8 7 7 6 7 6 6 6 7 8 8 9 8 7 7 5 5 5 4 3 2 2 3 2 2 1
 13 12 12 11 10 10 9 9 9 7 7 7 8 9 9 9 9 9 8 7 7 6 5 5 0 -1 -2 -2 -2 -1 -3 -4 -4 -5 -5 -5 -7 -6 -6 -7 -7 -7 -8 -8 -9 -8 -9 -10 -11 -7 -7 -7 -6 -7 -7 -8 -7 -6 -5 -5 -5 -3 -2 -1 -1 0 0 1 4 5 6 7 8 8 7 6 6 6 5 5 5 4 4 6 7 7 7 6 5 5 4 4 4 3 2 2 3 3 2 2
 13 12 11 10 10 9 9 9 9 8 7 8 9 9 9 10 10 9 8 8 7 6 5 4 0 -1 -2 -2 -1 -2 -3 -4 -3 -5 -5 -6 -6 -6 -6 -6 -6 -7 -7 -7 -7 -8 -10 -10 -11 -7 -6 -7 -7 -7 -8 -7 -7 -6 -6 -5 -5 -3 -3 -2 -1 0 0 2 3 4 6 6 7 8 6 5 5 5 5 5 4 4 4 5 6 7 6 5 4 4 4 4 4 3 3 3 3 3 3 3
 12 12 12 11 9 9 9 9 9 9 8 8 9 10 9 9 10 10 8 8 7 5 5 5 0 0 -1 -2 -1 -2 -2 -3 -5 -4 -4 -5 -5 -5 -5 -5 -6 -6 -6 -7 -7 -8 -9 -10 -10 -7 -7 -8 -8 -8 -8 -8 -7 -6 -5 -5 -5 -4 -3 -2 -1 0 0 1 2 3 5 6 7 7 6 5 5 4 4 4 3 3 3 5 5 4 5 4 3 3 3 4 3 4 4 3 3 3 3 3
 13 12 12 11 10 10 9 9 9 9 9 8 10 10 10 10 9 8 9 7 7 5 3 3 0 0 -1 -1 -1 -1 -2 -2 -2 -3 -3 -4 -4 -5 -4 -4 -5 -5 -6 -7 -8 -8 -9 -10 -10 -7 -8 -9 -8 -9 -8 -8 -6 -5 -5 -4 -4 -4 -3 -3 -2 -1 0 0 2 2 4 5 5 6 6 4 3 3 2 2 2 3 2 3 3 4 4 4 4 4 4 4 4 2 2 2 2 2 2 3
 12 11 11 11 11 9 9 9 9 9 10 9 11 11 11 10 9 9 8 8 6 3 2 3 0 0 0 -1 -1 -1 -2 -2 -2 -3 -3 -4 -4 -4 -4 -4 -5 -5 -6 -6 -7 -7 -8 -9 -10 -8 -8 -8 -9 -9 -8 -6 -5 -5 -5 -4 -4 -3 -3 -3 -1 0 0 1 2 3 4 5 5 6 4 3 2 2 2 2 2 3 3 3 3 3 4 4 4 5 5 4 3 2 2 1 2 2 3 3
 13 12 12 12 11 11 10 9 8 10 9 8 12 11 10 10 9 9 8 7 5 2 2 2 0 1 0 0 -1 -1 -2 -1 -2 -2 -3 -3 -4 -4 -3 -3 -5 -6 -5 -6 -6 -7 -8 -9 -10 -8 -9 -9 -9 -8 -8 -6 -6 -5 -4 -4 -4 -3 -2 -2 -1 -1 0 0 2 3 4 4 5 5 4 3 2 2 1 1 2 2 2 3 3 3 3 3 3 4 5 3 3 2 2 2 2 2 3 3
 12 12 12 11 11 11 10 9 9 9 8 9 11 11 10 9 9 9 7 6 4 3 3 2 1 1 1 0 0 -1 -1 -1 -2 -3 -3 -4 -3 -3 -3 -4 -5 -5 -6 -6 -6 -6 -7 -9 -10 -9 -9 -9 -8 -8 -7 -6 -5 -5 -4 -5 -5 -3 -3 -2 -1 -1 0 2 3 4 5 5 6 6 3 2 1 1 1 1 2 2 2 2 2 1 4 4 4 4 4 4 2 2 2 1 2 2 3 3
 12 12 12 12 11 11 11 10 9 9 9 9 11 11 9 9 9 8 7 6 5 2 2 2 1 1 1 -1 -1 0 -1 -1 -1 -2 -2 -3 -4 -3 -3 -4 -5 -6 -6 -6 -6 -6 -7 -8 -9 -9 -9 -9 -8 -7 -7 -5 -6 -5 -4 -4 -5 -3 -2 -1 0 -1 0 2 3 3 4 5 5 6 3 2 1 1 1 1 1 2 1 2 1 1 3 3 3 3 3 3 2 2 2 3 3 2 2 2
 13 13 12 11 11 11 11 11 10 10 9 9 11 11 10 9 9 8 6 6 5 2 2 1 1 1 1 -1 -1 -1 -1 -1 -2 -2 -2 -3 -3 -4 -3 -5 -6 -6 -5 -5 -6 -6 -6 -7 -8 -9 -9 -8 -7 -7 -6 -6 -6 -6 -4 -4 -4 -2 -2 -2 -1 0 0 2 3 2 3 3 4 4 2 2 2 2 2 1 2 2 2 1 1 1 2 2 2 3 3 3 2 2 2 3 3 2 2 2
 13 13 12 12 12 12 12 11 11 11 11 11 11 11 10 9 9 9 7 6 4 4 3 2 1 1 0 0 0 -1 -2 -1 -2 -3 -3 -3 -4 -4 -2 -6 -5 -5 -6 -6 -6 -6 -6 -7 -8 -9 -8 -8 -7 -6 -6 -6 -6 -6 -4 -4 -4 -2 -2 -2 -1 -1 -1 1 1 2 1 3 3 3 2 2 1 2 2 2 1 1 2 1 1 1 1 1 1 2 2 2 3 2 2 3 3 2 2 2
 13 12 11 11 10 9 9 8 8 7 6 5 4 4 4 4 4 3 3 2 2 2 1 2 2 2 2 2 3 3 2 2 2 2 2 1 0 0 0 0 -1 -1 -2 -3 -4 -5 -6 -7 -8 -8 -8 -8 -8 -7 -7 -7 -7 -7 -7 -7 -7 -8 -7 -6 -6 -4 -4 -5 -5 -5 -5 -6 -5 -5 -3 -3 -2 -2 -1 -1 -1 -1 -1 -1 -1 -1 -1 0 0 0 0 0 1 1 1 2 2 2 2 2
 13 12 11 10 11 10 9 8 8 7 6 5 5 4 4 4 4 4 2 1 2 2 2 2 2 2 2 3 4 3 3 2 3 3 3 2 1 1 0 0 0 -1 -2 -3 -3 -5 -5 -6 -7 -7 -7 -7 -6 -6 -6 -6 -6 -6 -7 -6 -7 -7 -7 -6 -5 -4 -4 -5 -5 -5 -5 -6 -5 -4 -4 -3 -3 -1 0 0 0 -1 -2 -1 -1 -1 0 0 0 1 0 1 1 1 2 1 2 2 2 2
 13 12 11 10 10 10 9 9 8 7 6 5 5 5 4 4 4 4 3 2 3 3 3 3 2 2 2 3 4 4 4 3 2 3 2 1 2 1 1 0 0 -1 -2 -3 -4 -4 -5 -5 -6 -6 -6 -4 -4 -5 -5 -5 -5 -5 -7 -6 -7 -6 -6 -6 -5 -4 -4 -5 -4 -5 -5 -5 -5 -5 -5 -3 -2 -1 -1 0 0 0 -1 0 0 0 0 1 1 1 1 1 2 1 2 1 2 2 1 2
 12 11 10 10 10 10 9 9 9 7 7 6 5 5 4 5 5 4 3 4 4 4 4 4 2 3 3 3 4 5 4 5 5 3 3 3 2 2 2 0 0 0 -2 -3 -3 -3 -5 -5 -5 -5 -3 -3 -3 -3 -3 -4 -5 -4 -6 -7 -7 -6 -6 -5 -5 -4 -4 -5 -5 -4 -5 -5 -5 -5 -4 -3 -2 -1 0 0 0 0 0 0 1 2 1 2 2 2 1 1 2 1 1 1 2 2 2 2
 12 12 11 11 11 11 9 9 8 8 8 7 6 6 5 5 4 4 4 4 4 5 5 4 3 4 4 4 4 5 5 6 5 5 5 4 2 2 1 1 1 0 -2 -3 -3 -3 -3 -5 -5 -3 -3 -2 -2 -2 -2 -3 -4 -4 -6 -6 -7 -6 -6 -6 -4 -3 -4 -6 -6 -5 -5 -5 -5 -5 -5 -4 -3 -1 0 0 0 0 0 2 2 2 2 2 2 2 1 1 2 2 2 1 2 2 2 2
 11 12 11 12 11 11 9 9 9 8 9 7 6 6 5 5 5 5 4 4 5 5 5 5 3 4 4 5 6 6 6 7 6 5 5 4 2 2 1 1 1 0 -2 -2 -3 -2 -4 -4 -4 -3 -2 -2 -1 -2 -2 -3 -4 -4 -5 -6 -6 -5 -6 -5 -5 -5 -5 -6 -6 -4 -5 -5 -5 -4 -5 -4 -3 -1 0 1 1 1 2 2 3 2 2 2 2 2 1 1 2 2 1 2 2 2 3 2
 12 11 12 11 11 11 10 9 8 8 8 8 6 6 6 6 5 5 5 5 5 5 5 5 4 5 5 5 6 7 7 6 5 6 5 6 3 3 2 2 0 0 0 -2 -2 -2 -3 -3 -4 -1 -1 -1 0 0 0 -2 -3 -2 -3 -5 -5 -5 -6 -5 -6 -6 -6 -6 -4 -3 -4 -4 -4 -4 -6 -4 -2 -2 0 2 2 3 4 4 4 4 2 3 2 1 2 3 2 2 2 2 2 2 2 2
 11 11 11 11 11 11 9 8 8 7 7 7 6 6 6 5 5 5 5 5 5 5 5 5 4 5 5 5 5 6 5 5 5 5 5 5 4 3 2 1 1 0 -2 -3 -3 -3 -3 -4 -3 -1 -1 0 0 -1 0 -2 -3 -2 -3 -4 -5 -5 -5 -5 -5 -5 -5 -5 -4 -4 -3 -4 -5 -4 -4 -4 -3 -1 0 1 2 3 4 5 5 5 4 3 3 2 2 2 2 2 2 1 1 2 1 2
 11 11 11 10 10 10 8 8 7 6 7 6 7 6 6 5 5 6 5 6 6 5 6 6 4 4 3 4 4 6 5 5 6 5 6 5 4 3 3 2 1 0 -1 -2 -3 -2 -3 -3 -2 -1 0 0 0 0 0 -2 -2 -2 -4 -4 -4 -4 -4 -4 -5 -4 -7 -4 -3 -4 -3 -4 -4 -4 -5 -4 -4 -2 0 0 3 3 4 6 5 6 5 4 2 3 3 3 2 2 2 1 1 1 1 2
 11 10 11 10 9 9 8 7 6 6 6 7 6 6 6 6 6 6 5 5 5 5 6 6 4 4 4 4 4 5 4 5 5 6 6 6 4 3 3 2 0 0 0 -1 -2 -2 -2 -2 -2 -1 0 0 0 0 0 -1 -2 -2 -3 -3 -3 -3 -3 -3 -3 -5 -5 -4 -3 -3 -4 -4 -4 -4 -6 -6 -5 -2 0 0 3 4 5 6 7 7 5 4 4 3 4 4 3 1 1 1 1 1 1 1
 9 9 9 8 8 7 7 7 6 5 5 5 6 6 6 7 7 6 6 6 5 6 7 7 4 4 3 4 4 4 4 5 4 5 6 5 4 4 3 1 0 0 0 -1 -1 -1 -2 -2 -2 0 0 0 0 0 0 -2 -3 -3 -1 -2 -2 -3 -3 -3 -4 -4 -5 -4 -4 -4 -4 -4 -4 -4 -6 -6 -5 -1 0 0 3 4 5 6 7 7 6 6 5 5 5 5 2 1 1 1 1 1 1 1
 10 9 9 9 7 7 6 7 6 6 6 5 7 7 6 7 7 7 6 6 6 5 6 7 5 5 5 4 4 3 4 4 3 4 5 6 4 4 3 1 1 0 0 -1 0 -1 -2 -2 -2 0 0 0 0 0 0 0 -1 -1 -1 -1 -2 -3 -3 -3 -4 -4 -5 -4 -4 -5 -5 -4 -4 -4 -6 -6 -4 -2 0 0 2 3 4 6 8 8 7 7 6 5 5 5 3 2 1 1 1 1 1 0
 9 9 10 9 9 8 9 9 8 8 8 7 7 6 5 5 6 5 4 6 6 7 7 7 6 5 6 6 6 6 6 6 5 6 5 5 4 2 2 1 0 0 0 -1 -3 -2 -2 -1 -2 0 0 0 0 0 0 0 0 0 -1 -1 -1 -2 -3 -4 -3 -4 -3 -3 -3 -3 -5 -6 -6 -6 -5 -3 -1 -1 1 2 3 4 5 6 7 8 8 7 7 6 4 3 3 2 3 2 2 1 1 1
 10 9 9 9 9 9 9 10 9 8 9 8 8 7 6 7 7 6 7 7 7 8 8 8 6 5 6 7 6 7 6 5 6 5 4 5 3 2 2 0 0 0 0 0 -1 -1 -1 -1 -1 1 1 1 1 1 1 0 0 0 -1 -1 -1 -3 -3 -3 -4 -4 -4 -3 -4 -4 -5 -6 -6 -6 -4 -2 -2 0 1 2 3 4 4 5 6 7 7 7 6 4 4 3 2 1 1 1 1 1 1 1
 10 9 10 9 9 9 9 9 9 8 9 9 8 7 8 8 8 6 8 8 9 8 8 8 6 6 6 8 7 7 7 6 6 5 5 4 4 2 2 1 1 0 0 0 -1 -1 0 0 -1 2 2 2 1 1 1 0 0 0 -1 -1 -2 -4 -3 -3 -3 -3 -4 -3 -4 -5 -6 -6 -6 -6 -4 -3 -2 0 0 2 2 3 3 4 5 7 5 6 6 4 4 3 1 1 1 1 1 1 1 1
 10 10 10 10 9 9 8 9 9 9 9 9 9 9 8 8 8 8 9 9 10 10 9 10 7 7 8 8 8 8 7 8 7 6 5 5 4 2 2 1 0 0 0 0 -1 0 -1 0 0 2 3 3 2 2 2 0 0 0 -1 -2 -2 -3 -3 -4 -3 -3 -3 -4 -5 -6 -6 -6 -7 -7 -4 -3 -2 0 0 1 2 2 2 3 4 5 5 3 3 4 3 2 2 1 1 0 0 1 0 1
 11 11 11 10 9 9 9 10 10 9 9 9 10 10 10 10 10 10 10 10 10 10 9 9 7 7 8 9 9 9 9 8 8 6 5 5 3 2 1 0 0 0 0 0 0 0 0 0 0 3 3 3 2 2 2 0 0 0 -1 -2 -3 -4 -4 -3 -3 -2 -2 -4 -5 -6 -6 -6 -7 -7 -4 -4 -3 0 1 2 2 2 2 3 4 4 3 3 3 3 3 3 2 1 1 1 1 1 1 1
 12 11 11 10 10 9 9 10 10 9 10 9 11 10 10 11 11 11 11 11 11 11 10 10 7 7 7 9 9 10 9 8 8 6 5 5 3 2 2 0 0 0 0 0 1 0 0 0 0 4 4 4 2 2 2 1 0 0 -1 -2 -2 -4 -3 -3 -3 -2 -2 -4 -5 -5 -6 -7 -7 -7 -5 -4 -2 0 0 2 2 1 2 3 4 4 2 2 2 2 2 2 1 1 0 0 0 1 0 1
 12 11 11 10 10 10 10 10 11 11 11 11 11 12 11 11 12 12 12 11 11 11 11 11 7 9 9 9 10 9 9 8 7 6 6 5 3 2 2 2 1 0 0 0 0 1 0 1 1 4 3 4 3 3 2 1 0 -1 -2 -4 -4 -4 -4 -4 -4 -4 -4 -4 -5 -6 -6 -7 -8 -8 -5 -3 -2 -2 0 0 1 1 1 2 2 3 1 1 2 2 2 2 1 1 1 1 1 1 1 1
 11 12 11 11 11 10 11 11 11 11 11 11 12 12 12 12 12 11 11 11 11 11 11 11 9 9 9 9 9 10 9 9 8 7 7 6 3 2 2 3 2 1 1 0 1 2 1 2 2 4 4 3 3 3 2 0 0 -1 -3 -4 -5 -4 -4 -4 -4 -4 -4 -5 -6 -6 -7 -7 -8 -8 -5 -3 -3 -2 -1 0 0 0 1 1 1 2 1 1 2 2 2 2 1 1 1 1 1 1 1 1
 10 12 11 11 11 11 10 11 10 11 11 12 12 12 12 12 12 12 11 11 11 12 11 12 9 9 10 9 10 10 9 9 8 8 7 6 3 3 3 3 2 2 3 2 2 2 2 2 1 5 4 5 4 3 3 -1 -1 -1 -3 -4 -5 -5 -4 -5 -4 -5 -4 -5 -6 -7 -7 -6 -8 -8 -6 -4 -4 -3 -1 -1 0 0 0 1 1 2 0 1 2 2 2 1 1 1 2 1 1 2 1 1
 11 11 12 11 10 10 10 11 11 11 12 12 12 12 12 12 12 12 11 11 11 12 12 12 10 10 10 10 10 10 9 9 9 7 6 6 3 3 3 3 3 3 3 3 2 3 3 2 1 5 5 5 4 3 3 0 -1 -1 -3 -4 -5 -5 -5 -4 -5 -5 -5 -7 -7 -7 -7 -7 -7 -8 -6 -6 -5 -3 -2 -2 0 0 0 1 1 1 1 2 2 1 1 0 1 1 1 2 2 2 2 2
 11 11 11 11 10 11 10 10 11 11 12 12 13 13 12 13 13 13 11 11 11 11 11 12 10 10 9 10 10 10 8 8 8 7 6 6 3 4 4 5 4 3 4 3 3 3 3 3 3 5 5 4 3 2 2 0 0 -2 -3 -4 -5 -6 -5 -5 -5 -5 -6 -7 -7 -8 -7 -7 -8 -8 -7 -6 -5 -4 -3 -2 -2 -1 0 0 0 0 1 1 2 1 0 0 0 0 1 1 1 1 1 1
 11 11 11 10 10 9 10 10 11 12 12 12 13 12 12 13 14 13 11 11 11 11 11 12 10 10 10 10 10 10 7 7 7 6 6 6 5 4 5 6 6 5 4 4 4 4 4 4 3 4 4 4 1 1 1 0 0 0 -2 -3 -5 -5 -5 -6 -6 -6 -7 -7 -7 -8 -7 -8 -8 -9 -7 -7 -6 -4 -4 -3 -2 -2 -1 -1 -1 0 0 0 0 0 0 0 0 0 0 0 0 1 1 1
 10 10 10 10 10 10 11 11 11 13 12 13 13 13 13 13 13 12 11 12 12 12 11 12 10 11 10 9 9 9 8 7 7 6 6 7 6 6 6 6 6 6 5 5 4 4 5 4 3 4 3 3 1 1 0 0 0 0 -2 -3 -4 -5 -6 -6 -7 -7 -8 -8 -8 -8 -7 -8 -8 -9 -7 -8 -7 -5 -5 -4 -3 -3 -2 -2 -2 -1 0 0 0 0 0 0 0 0 0 0 0 1 1 1
 9 9 8 8 9 10 10 9 9 9 10 10 10 10 11 10 11 11 12 11 11 11 11 12 11 10 10 9 9 9 9 9 8 8 9 9 9 8 7 6 5 4 4 5 4 4 4 3 3 4 2 2 1 0 0 0 0 0 -1 -1 -1 -2 -1 -2 -2 -3 -4 -5 -5 -6 -6 -7 -8 -8 -8 -7 -7 -7 -6 -7 -6 -5 -4 -3 -2 -1 -1 -1 -2 0 0 0 0 0 0 0 0 1 1 1
 8 8 8 8 9 9 9 9 9 9 9 10 10 10 11 11 11 11 11 10 10 11 11 11 10 10 10 9 8 9 9 10 9 8 9 9 8 8 7 6 5 4 4 4 4 5 4 3 3 3 2 2 1 0 0 0 0 0 0 0 -1 0 0 0 -1 -3 -4 -4 -4 -5 -6 -7 -8 -8 -7 -7 -7 -6 -6 -6 -5 -5 -4 -2 -1 -1 -2 -1 -1 -1 -1 0 0 -1 0 0 0 1 1 1
 8 7 7 8 9 10 9 9 9 9 10 10 11 11 11 11 11 11 11 10 10 10 10 11 10 9 8 9 8 8 9 9 8 9 8 8 8 8 8 7 6 5 5 4 5 5 4 3 3 3 3 2 1 0 0 0 0 0 0 0 0 1 0 0 0 -2 -3 -5 -5 -5 -5 -6 -7 -8 -7 -7 -7 -6 -5 -5 -5 -4 -3 -2 -1 0 -1 -1 -1 0 -1 -1 -1 -1 -1 -1 0 0 1 0
 8 7 7 8 8 8 9 10 9 10 9 10 10 10 10 11 11 10 11 10 9 9 9 9 9 8 8 8 8 7 8 7 7 8 8 8 8 8 8 7 6 6 5 6 6 5 5 4 3 4 3 2 2 1 0 0 0 0 0 0 0 1 1 1 0 0 -2 -4 -5 -5 -4 -5 -7 -7 -6 -6 -6 -5 -3 -4 -4 -2 -1 -1 0 0 -1 -1 -1 -1 -1 -1 -1 -2 -1 -1 0 0 0 0
 7 7 7 8 8 8 9 9 9 9 9 9 10 10 11 11 10 10 10 10 10 9 9 9 8 7 7 8 9 7 7 7 7 7 8 7 7 8 8 7 6 6 6 7 6 6 5 4 4 4 3 2 2 2 1 0 0 0 0 0 0 2 1 1 0 0 -1 -3 -4 -4 -4 -5 -7 -7 -5 -5 -5 -3 -2 -3 -3 -1 -1 0 0 0 -1 -1 -1 -1 -2 -2 -2 -2 -2 0 0 0 0 0
 7 7 7 7 7 6 8 8 9 9 9 9 10 10 10 10 10 10 10 10 10 9 9 8 7 7 8 8 8 7 6 7 6 7 7 8 7 7 8 7 6 6 6 6 6 6 5 4 3 4 3 2 1 2 0 0 0 0 0 0 0 2 1 1 0 0 -1 -2 -3 -3 -4 -5 -6 -7 -4 -4 -4 -3 -3 -2 -2 -1 0 0 0 0 0 -1 -1 -2 -2 -3 -2 -2 -1 0 -1 0 0 0
 8 9 9 7 8 8 8 9 9 9 9 10 10 9 10 10 9 9 10 9 10 9 9 9 8 7 6 7 5 6 6 6 6 6 7 6 6 6 5 6 6 6 6 6 6 5 4 4 4 4 4 3 3 2 1 1 1 0 1 1 0 2 1 0 0 0 0 -1 -3 -4 -4 -5 -6 -6 -4 -2 -2 -2 -2 -2 -2 0 0 0 0 1 -1 -1 -1 -2 -2 -2 -2 -1 -1 -1 0 0 0 0
 8 9 8 8 8 9 9 9 10 10 9 10 9 9 9 9 9 9 10 10 9 8 8 8 8 7 7 5 3 5 5 5 5 6 6 6 5 5 5 6 6 6 6 6 6 5 5 4 3 5 4 4 4 3 2 2 2 1 1 1 2 2 2 1 0 0 0 -2 -2 -3 -4 -5 -6 -7 -2 -2 -2 -2 -2 -2 0 0 0 0 1 1 0 0 -1 -1 -2 -2 -1 0 0 0 0 -1 0 0
 8 8 7 8 8 9 8 9 9 10 10 11 9 9 9 10 9 9 9 9 9 8 8 9 7 7 6 5 4 4 4 5 6 6 5 6 5 5 5 6 6 6 7 6 6 5 4 4 4 5 5 5 4 3 3 2 2 1 1 1 2 3 2 1 0 0 0 -1 -3 -3 -4 -5 -6 -6 -2 -2 -2 -2 -2 -1 0 0 0 1 1 1 0 0 -1 0 -1 -2 0 -1 0 0 0 -1 0 0
 8 8 8 8 9 10 9 9 9 11 11 10 9 10 9 9 10 10 9 8 8 8 8 8 6 6 6 5 4 3 4 5 6 6 6 5 6 5 5 6 7 6 7 7 6 6 5 4 4 5 5 5 4 4 4 2 2 3 2 3 3 3 2 1 1 0 0 -2 -3 -4 -4 -3 -4 -6 -3 -2 -1 -1 -1 -1 0 0 0 0 0 1 0 0 0 0 0 0 0 0 0 0 0 0 0 0
 7 7 7 9 9 10 9 9 9 11 10 10 10 10 10 10 10 10 9 8 8 8 9 8 6 6 5 4 4 4 3 4 4 5 6 6 6 6 6 6 7 6 7 7 6 6 5 5 4 5 5 5 5 5 5 3 3 3 4 4 3 3 2 2 0 0 0 -2 -3 -3 -3 -4 -4 -5 -2 -2 -2 -1 -1 0 0 0 0 0 0 1 0 0 0 0 0 0 0 0 0 0 0 0 0 0
 7 8 8 8 10 10 10 10 10 10 11 11 9 10 9 10 10 10 9 9 8 8 8 8 5 5 6 4 4 3 3 3 3 4 5 5 6 6 6 6 6 7 7 7 6 5 5 4 4 5 5 4 4 5 4 4 4 3 4 4 4 3 3 2 1 0 0 -3 -2 -3 -3 -4 -4 -5 -2 -2 -2 -1 0 -1 0 0 1 0 0 0 0 0 0 0 0 0 0 0 0 1 1 1 1 1
 8 8 8 8 7 8 8 8 9 9 9 10 10 9 9 9 8 9 8 8 7 6 6 6 6 6 5 5 5 6 6 5 5 5 5 5 6 6 5 6 6 4 4 4 3 3 3 3 2 4 3 3 3 3 3 4 4 4 4 5 5 3 2 2 1 0 0 0 0 -1 -2 -2 -3 -3 -2 -2 -1 -1 -1 -1 0 0 0 0 0 1 0 1 1 1 1 1 1 1 0 0 1 1 1 1
 7 6 7 7 6 7 7 7 8 8 8 9 9 9 9 8 8 8 8 9 7 7 6 7 6 6 6 5 5 5 6 6 6 6 5 5 6 7 7 6 6 6 4 4 3 3 4 3 3 4 4 3 2 2 3 3 4 4 5 5 4 3 2 1 1 0 0 0 0 0 -1 -2 -2 -4 -2 -2 -1 -2 -2 -1 0 0 0 0 1 1 0 1 1 0 0 1 0 0 0 0 0 1 1 1
 6 6 7 7 6 6 7 7 7 7 7 8 9 8 9 8 8 8 8 8 7 7 6 6 6 5 6 5 5 5 4 6 5 6 6 6 7 7 7 8 7 6 4 4 4 4 4 3 2 4 3 3 2 3 2 3 3 4 5 5 5 3 3 2 1 0 0 0 0 0 -1 -1 -2 -3 -2 -2 -2 -1 -1 0 -1 0 0 0 0 0 0 0 1 0 0 0 0 0 0 0 0 0 0 1
 6 5 6 6 6 6 6 6 6 6 7 8 8 8 8 8 8 8 7 7 8 7 7 7 5 5 5 5 5 5 5 6 6 6 7 6 7 8 8 8 8 8 5 5 5 4 4 4 3 4 4 3 2 2 3 2 2 3 4 5 5 3 3 2 2 2 1 0 0 0 0 0 0 -1 -2 -2 -1 -1 0 0 0 0 0 0 0 1 0 0 0 0 0 0 0 0 0 0 0 1 0 1
 4 4 4 5 5 5 4 5 5 6 8 8 8 8 8 8 8 8 7 7 7 7 7 6 6 6 5 4 4 4 5 6 6 6 6 7 8 8 8 7 7 7 6 6 5 4 4 4 3 4 4 3 2 2 2 2 2 2 5 5 6 4 4 3 2 2 2 0 0 0 0 0 0 -1 -2 -2 -2 0 0 0 0 0 0 0 0 0 0 0 0 0 0 0 0 0 0 0 1 1 1 1
 4 4 4 4 4 4 5 5 5 6 7 8 7 8 7 8 8 8 8 8 8 7 7 7 6 6 5 5 4 4 5 6 6 7 7 7 8 8 8 7 7 7 6 6 5 4 4 4 3 5 4 4 3 2 2 2 2 3 5 5 6 4 4 3 3 3 2 1 1 0 0 0 0 -1 -2 -2 -2 0 0 0 0 0 0 0 0 0 0 0 0 0 0 0 0 0 0 0 0 1 1 1
 4 3 3 3 3 3 4 5 5 6 6 7 7 7 7 7 8 9 9 8 7 8 8 7 6 7 7 6 5 5 5 6 7 7 7 7 8 8 7 7 7 7 6 6 6 6 6 4 4 5 4 5 4 3 3 2 4 4 4 5 6 4 3 3 3 2 2 2 1 1 0 0 0 0 -2 -2 -1 -1 0 0 0 0 0 0 0 0 -1 0 0 0 0 0 0 0 1 1 1 1 1 1
 3 3 3 2 2 2 4 5 4 4 5 6 6 6 7 8 8 9 8 9 9 9 8 8 7 8 7 6 6 6 6 6 6 7 7 7 7 7 7 6 6 6 6 6 6 7 6 4 4 4 5 5 4 4 3 4 4 4 4 5 5 4 3 3 2 2 2 1 1 1 0 0 -1 -1 -2 -1 -1 0 0 0 0 1 0 0 0 0 0 0 0 0 0 0 0 0 0 1 1 1 1 1
 3 3 3 2 2 2 4 4 5 4 5 6 6 7 8 9 8 8 9 10 10 10 9 8 7 7 7 6 6 6 6 6 6 6 7 7 8 7 7 5 6 6 7 7 6 8 6 5 5 4 4 5 3 3 2 4 4 4 5 4 4 3 4 3 3 2 2 1 1 1 0 0 0 0 -2 -1 0 -1 0 0 0 0 0 -1 0 0 0 0 0 0 0 0 0 0 0 0 1 1 0 1
 2 2 2 2 2 2 3 3 3 4 5 6 7 7 8 9 9 9 10 10 11 10 9 9 7 7 6 6 6 6 5 5 6 7 8 8 7 6 6 6 6 6 7 7 8 8 7 7 6 4 3 3 3 2 3 4 4 4 4 5 5 3 3 2 2 2 2 1 1 0 0 0 0 0 -1 -1 -1 0 0 0 -1 -1 -1 -1 -1 -1 0 0 0 0 0 0 0 0 0 0 1 1 1 1
 2 2 1 1 1 2 2 3 3 4 5 6 6 7 7 7 8 9 9 10 11 9 8 9 6 5 5 6 7 7 5 5 6 7 7 7 7 7 6 6 6 5 7 7 8 7 7 7 6 4 4 4 3 3 3 4 4 5 4 4 5 3 3 3 2 1 1 1 1 0 0 0 0 -1 -2 -1 0 0 0 0 -1 -1 -1 -1 -1 0 0 0 0 0 0 0 0 0 0 0 0 0 0 1
 1 1 1 0 0 1 2 3 2 4 5 6 6 6 7 7 8 8 10 11 10 8 8 7 6 5 6 7 7 7 6 6 7 6 6 7 7 8 7 6 6 6 7 7 7 7 7 7 6 5 5 4 3 3 3 5 5 5 4 4 4 4 3 3 1 1 1 1 1 0 1 0 0 0 -1 -1 -1 -1 -2 -1 -1 -1 -1 -1 -1 0 0 0 0 -1 -1 -1 -1 -1 0 0 0 0 0 0
 1 0 0 1 1 1 2 3 3 4 5 6 6 6 6 7 7 7 8 9 8 8 7 6 6 6 6 6 7 6 6 6 6 7 7 7 8 8 8 7 7 6 7 7 6 7 7 6 5 5 4 4 4 3 4 5 5 5 4 5 4 4 4 3 2 1 0 1 0 0 0 0 0 0 -2 -1 -2 -2 -2 -2 -3 -1 -1 0 0 0 0 0 -1 0 0 0 0 -1 0 0 0 0 0 0
 0 0 0 0 1 1 3 3 4 4 4 5 5 5 5 6 7 8 8 8 8 8 7 7 7 6 7 7 7 6 6 6 7 8 8 8 8 8 8 8 7 7 6 6 6 6 6 5 5 5 4 4 5 5 5 5 5 6 5 5 4 4 4 4 3 1 1 0 0 0 0 0 0 -1 -1 -2 -2 -3 -3 -2 -2 -1 -1 -1 -1 -1 0 0 0 0 0 0 0 0 0 0 0 0 0 0
