 0 9 20 29 38 41 46 40 38 40 34 31 24 16 18 10 6 6 0 0
 1 8 12 24 31 37 31 35 36 44 44 40 28 22 25 20 12 6 4 4
 -1 8 10 19 32 26 19 31 34 40 48 47 33 30 33 25 14 9 12 10
 -3 8 13 22 29 27 23 33 41 45 44 46 35 35 37 26 21 22 18 17
 -5 7 17 20 28 33 37 37 42 52 49 41 38 34 37 35 27 21 24 21
 0 12 15 21 27 30 46 45 49 56 44 40 38 30 38 34 30 21 14 15
 8 12 15 18 22 32 47 46 49 54 46 38 34 38 36 33 29 21 15 13
 15 17 20 26 26 34 44 45 48 43 37 32 27 30 35 32 24 19 16 13
 16 17 32 30 24 36 42 48 48 52 41 33 29 32 38 31 19 15 18 14
 24 24 20 20 14 22 37 44 55 47 43 40 34 35 35 30 19 18 12 19
 23 26 28 22 19 33 37 42 44 39 41 38 31 34 38 32 16 16 24 21
 24 33 34 32 25 33 44 36 45 31 34 33 40 40 40 27 18 22 21 16
 20 25 32 38 37 37 32 27 31 25 29 31 43 40 33 32 22 22 19 14
 19 23 30 41 39 30 34 31 30 22 19 30 40 36 34 33 28 23 20 10
 23 28 33 43 41 41 35 23 27 15 22 35 31 36 35 29 18 12 10 8
 15 23 27 34 32 26 19 10 13 8 14 25 24 28 28 20 13 9 5 4
 8 14 18 21 26 12 1 0 8 0 5 14 3 5 13 11 11 -1 0 0
 5 8 13 8 12 1 -6 -3 -4 -5 -6 -4 -8 -1 -1 -6 -1 -6 -4 0
 7 6 9 5 7 -6 -6 -4 -16 -10 -18 -11 -10 -15 -1 -2 -4 -6 -6 2
 0 0 0 -2 -7 -13 -13 -11 -13 -16 -17 -13 -10 -9 -7 -7 -6 -4 -2 0
