 0 9 9 12 18 20 22 25 23 24 22 23 16 23 28 31 36 40 43 37 42 41 45 49 55 57 63 61 66 65 71 65 62 59 52 54 53 43 46 42 44 44 45 39 37 35 35 39 41 38 43 44 47 41 43 54 53 53 50 53 50 57 54 51 52 53 52 53 54 54 54 53 56 50 54 52 52 50 43 45 43 36 37 38 29 27 22 19 13 15 17 13 16 16 19 14 9 15 9 0
 8 10 9 19 21 21 26 27 28 22 25 18 18 23 27 31 33 34 32 33 38 41 42 45 54 58 60 60 62 65 64 64 60 47 46 47 37 33 35 40 43 44 40 39 39 37 39 40 40 39 39 41 38 35 44 54 57 55 55 55 57 59 54 56 55 56 54 54 54 55 56 56 57 54 58 53 51 45 43 44 40 33 34 36 30 27 23 21 16 16 21 20 22 20 17 16 17 19 8 -1
 13 14 14 22 23 26 31 30 26 21 23 16 24 25 33 32 30 32 23 31 36 39 41 45 46 54 51 61 59 62 60 55 48 39 40 35 33 31 31 36 40 40 38 39 39 35 40 36 32 40 37 39 43 40 47 57 55 57 60 58 64 59 59 56 57 59 54 51 54 54 58 59 59 61 61 55 44 48 47 42 44 39 35 35 28 28 26 22 21 19 21 23 23 23 18 18 17 14 6 0
 15 21 17 23 31 34 33 29 25 24 17 16 19 18 19 28 26 25 26 25 29 38 40 36 42 44 48 56 50 54 49 42 37 32 27 25 30 24 22 31 30 41 38 37 34 34 30 35 36 38 37 37 40 46 47 54 56 57 64 63 68 64 65 66 64 63 62 52 59 62 62 67 63 60 62 57 54 46 43 42 45 38 38 31 22 25 29 23 19 18 29 29 24 23 18 20 18 9 7 1
 23 24 26 35 38 40 32 29 28 20 15 15 17 13 16 17 19 22 21 24 27 35 38 35 36 36 43 44 43 45 41 40 33 24 22 18 20 18 21 26 22 31 32 34 34 30 33 34 37 39 36 37 41 45 49 54 53 57 64 64 70 67 68 68 66 65 65 62 63 63 63 64 64 61 65 61 57 49 45 44 39 36 36 25 18 20 26 27 20 28 34 33 27 26 25 23 17 10 7 0
 26 29 25 36 39 36 36 31 29 21 20 18 14 13 19 13 16 23 17 20 23 28 31 26 29 32 36 38 39 42 36 36 28 23 16 9 19 14 22 20 22 26 25 27 29 27 27 31 29 35 36 35 43 44 46 57 54 60 65 69 69 64 66 68 68 69 73 67 66 65 65 62 66 62 69 65 62 54 46 47 39 33 36 25 21 22 26 29 23 28 34 34 29 28 27 24 17 8 6 -2
 30 38 35 42 44 41 35 30 27 24 21 18 15 13 18 17 13 14 14 13 15 20 22 21 29 25 24 30 24 29 32 14 8 3 -4 -3 14 14 15 16 15 15 24 30 25 28 34 34 31 38 38 36 41 48 50 53 62 61 65 71 72 61 59 60 62 72 72 72 69 68 65 58 62 54 75 69 67 60 52 46 38 38 30 29 27 21 25 28 29 28 31 35 34 24 18 13 12 7 7 0
 41 43 46 46 45 41 35 33 26 21 22 16 11 12 15 12 9 10 11 10 14 18 20 17 21 22 24 19 16 20 10 4 1 -12 -14 -10 6 10 8 2 5 11 22 27 29 23 28 32 33 35 36 36 45 49 54 61 65 68 72 73 77 59 59 61 71 77 74 67 67 65 63 61 62 56 78 74 68 60 56 49 43 42 40 35 32 26 27 30 27 28 28 31 25 18 15 14 14 7 6 4
 45 45 46 48 45 35 34 30 23 14 17 13 10 11 16 13 6 6 8 7 7 12 13 14 17 18 18 16 15 19 5 0 -3 -14 -14 -12 2 4 1 0 0 11 19 22 24 20 25 29 31 35 37 35 43 49 49 60 62 66 75 75 79 61 57 56 69 70 65 63 66 66 61 56 59 55 82 77 71 65 58 55 42 44 36 37 33 26 24 27 28 28 29 27 27 20 13 13 11 9 7 5
 48 54 54 44 38 32 33 24 21 13 11 8 9 9 9 6 6 5 4 5 3 5 7 7 13 7 11 11 6 7 0 -9 -11 -17 -16 -19 -2 -13 -13 -10 -3 2 13 9 17 16 19 25 28 36 36 39 43 50 52 58 68 72 78 75 79 60 62 62 65 62 64 64 62 57 57 59 55 56 85 82 81 68 65 61 49 49 47 42 36 34 26 29 27 29 29 28 26 19 17 12 13 15 7 7
 56 57 53 45 40 34 26 22 20 15 11 11 9 7 3 6 9 5 0 0 0 1 4 7 1 0 0 1 1 -2 -14 -17 -21 -22 -21 -23 -20 -20 -22 -13 -9 -3 5 8 14 14 18 23 25 39 39 41 45 49 49 59 64 68 68 69 73 62 58 62 63 60 61 59 60 60 56 55 55 52 90 85 81 77 72 67 52 49 48 43 38 34 27 30 28 31 30 33 24 20 15 14 16 19 12 7
 61 58 54 45 37 39 28 21 17 16 13 7 10 7 1 3 0 0 -3 -3 -6 -1 2 4 -3 -5 -7 -6 -6 -8 -21 -22 -27 -24 -28 -30 -26 -23 -22 -14 -13 -10 0 4 9 14 19 21 32 39 41 41 47 45 50 56 59 65 69 69 72 64 63 63 61 60 59 60 60 57 57 52 55 49 96 87 86 83 75 68 55 53 50 41 37 31 32 32 32 36 29 33 23 20 14 18 22 18 10 8
 65 60 52 45 42 36 35 27 25 26 21 12 7 6 5 4 4 2 6 6 8 0 -3 -2 -8 -11 -10 -11 -17 -18 -22 -24 -23 -31 -32 -33 -29 -17 -9 -10 -2 1 8 17 18 21 23 25 28 40 47 49 47 53 52 56 59 56 56 61 66 69 62 61 63 60 57 53 47 49 45 44 40 45 98 85 79 75 67 65 64 54 46 45 42 38 36 40 36 38 32 27 27 19 18 14 11 15 14 11
 65 63 54 48 46 41 30 23 25 26 24 18 10 8 5 4 6 8 8 6 3 -3 -4 -4 -15 -13 -10 -18 -20 -20 -23 -26 -30 -34 -33 -30 -19 -14 -10 -3 -2 3 15 20 21 20 21 25 27 44 49 51 48 50 52 57 60 59 57 61 66 62 60 60 62 60 57 49 45 43 41 40 38 41 84 80 76 69 63 63 57 50 46 44 42 39 39 37 38 33 31 28 22 18 16 14 14 17 15 11
 61 59 55 49 48 50 28 26 26 23 25 20 17 10 3 5 9 12 7 3 0 -11 -5 -7 -15 -14 -15 -19 -20 -24 -26 -25 -30 -29 -30 -32 -15 -14 -10 -3 -1 2 18 21 20 18 21 25 28 40 46 49 48 52 52 57 56 54 56 58 60 62 62 70 62 58 55 51 45 45 40 39 39 39 84 76 75 68 62 58 56 50 47 42 42 34 40 37 34 31 27 25 21 21 20 16 14 14 18 11
 62 60 57 50 45 41 30 31 31 26 28 23 17 8 6 5 14 15 7 3 -5 -10 -12 -10 -20 -18 -19 -21 -25 -24 -25 -28 -29 -31 -27 -23 -13 -6 -3 0 1 4 21 19 22 18 19 21 23 41 44 50 50 50 57 55 55 54 54 52 54 64 63 62 62 54 55 47 41 37 35 37 37 42 78 74 70 64 62 61 55 51 47 40 38 38 39 36 33 29 25 16 22 19 16 16 15 14 14 10
 68 64 59 48 44 39 34 35 34 31 33 29 16 13 11 15 18 15 8 6 -1 -12 -14 -14 -18 -20 -21 -23 -27 -26 -24 -23 -26 -22 -25 -23 -6 -2 -1 1 1 5 16 18 16 19 20 20 26 39 41 44 46 45 51 55 53 48 47 48 53 62 62 59 54 50 49 44 42 37 37 38 38 40 76 73 70 65 64 58 54 55 49 37 33 38 42 40 40 30 27 22 18 16 15 13 15 15 12 10
 68 63 63 50 43 38 34 36 35 29 33 25 18 17 16 16 18 14 10 1 -3 -12 -17 -18 -19 -18 -19 -26 -21 -23 -23 -21 -21 -20 -17 -14 -4 -6 -1 1 4 7 17 17 14 19 18 17 20 36 39 42 46 48 49 53 53 51 46 49 47 59 58 56 53 51 48 41 42 46 38 38 39 43 76 76 71 63 63 55 51 52 56 42 38 42 44 42 36 31 24 20 16 16 16 12 15 14 13 9
 71 64 62 57 43 40 36 34 34 35 30 31 21 16 13 5 6 12 5 -1 -5 -13 -21 -23 -18 -27 -25 -24 -25 -21 -22 -19 -15 -15 -14 -14 -9 0 2 4 5 7 13 18 16 17 20 24 26 33 39 38 41 47 52 51 52 49 47 44 40 55 50 48 43 47 47 43 41 35 34 35 40 40 79 74 65 63 53 48 51 48 52 48 50 44 46 34 31 32 27 21 17 19 17 11 13 12 11 11
 68 65 62 50 41 41 36 35 37 29 28 27 20 17 9 2 3 5 -2 -2 -11 -22 -25 -26 -29 -34 -31 -29 -27 -24 -16 -15 -15 -11 -13 -9 0 0 2 6 4 6 14 19 19 16 18 23 22 40 38 38 45 47 54 53 52 49 41 41 40 50 52 46 44 48 47 45 43 39 35 35 39 45 74 73 69 54 51 50 47 49 48 52 53 47 36 30 34 31 28 23 23 24 19 10 10 11 11 11
 72 67 63 53 46 40 34 33 38 27 27 28 16 14 11 2 3 4 0 -7 -12 -24 -25 -25 -30 -30 -29 -30 -31 -25 -13 -13 -11 -9 -7 -7 1 3 3 5 5 12 14 17 14 18 17 21 17 43 38 39 43 46 53 48 50 49 39 38 35 51 47 45 42 47 48 45 41 41 38 44 41 39 70 69 64 51 50 53 48 48 47 51 51 43 40 34 36 29 25 21 25 23 18 10 9 10 9 11
 71 62 53 53 51 45 35 37 38 28 26 25 15 6 4 3 0 -2 -7 -18 -19 -23 -32 -34 -31 -36 -35 -34 -27 -23 -13 -8 -5 -2 0 5 4 7 7 8 13 11 11 14 18 19 18 14 17 44 44 42 44 50 50 52 43 39 38 36 33 42 39 36 41 37 43 40 40 42 42 40 45 47 65 56 57 53 51 53 47 47 48 49 47 44 40 40 35 32 26 20 23 18 14 10 10 13 10 7
 64 60 59 54 54 47 39 41 37 28 24 24 14 6 6 1 -1 -5 -17 -23 -25 -32 -38 -38 -40 -36 -36 -30 -29 -23 -9 -6 -2 2 2 9 10 9 10 13 16 12 13 13 15 20 15 12 14 49 48 48 51 48 50 49 42 41 38 35 31 35 37 38 37 33 36 41 40 40 43 46 45 48 57 53 54 50 50 48 45 46 46 48 45 47 43 44 40 31 25 19 21 16 13 9 12 14 10 3
 63 60 56 55 50 48 39 41 33 30 26 23 20 6 5 0 -1 -12 -18 -25 -26 -29 -39 -42 -43 -36 -37 -25 -25 -24 -11 -6 -5 2 7 7 16 11 12 9 16 14 12 16 21 18 20 15 11 58 51 54 56 53 57 51 44 41 35 37 28 32 36 31 40 34 39 38 39 41 45 45 48 48 53 51 51 44 48 50 47 49 45 46 47 47 44 43 41 30 26 23 17 16 11 7 8 7 3 4
 61 48 39 36 30 32 28 23 23 16 14 14 15 5 4 0 -2 -3 -5 -18 -24 -28 -38 -42 -44 -31 -28 -26 -19 -18 -15 -1 0 2 8 10 7 12 17 13 19 23 16 19 23 28 29 26 25 56 53 53 54 56 54 51 51 49 46 48 43 42 46 44 43 44 45 48 44 48 47 45 46 53 52 46 47 42 40 37 37 37 37 36 40 42 39 31 25 25 20 15 16 12 6 5 6 2 0 1
 52 50 44 33 28 31 26 20 17 11 10 13 6 2 0 -1 -4 -5 -13 -18 -26 -36 -39 -45 -31 -29 -25 -18 -18 -15 3 7 8 13 14 13 17 20 20 23 27 25 28 26 26 34 31 27 26 56 56 59 62 61 55 54 55 50 51 53 50 47 47 47 44 43 48 46 43 45 44 43 42 46 48 46 43 41 42 39 39 38 36 40 40 41 31 27 23 16 15 15 12 15 12 3 2 1 3 1
 47 47 43 34 34 32 28 21 16 8 8 10 1 0 2 -4 -4 -1 -19 -24 -36 -36 -39 -43 -23 -24 -19 -6 -12 -9 6 7 11 19 19 17 18 23 25 30 32 30 32 34 31 40 34 34 30 55 60 64 65 59 58 53 54 55 56 53 55 52 50 46 44 44 46 50 46 44 42 46 43 48 44 45 44 44 45 46 44 40 40 39 42 43 31 25 16 11 8 10 7 11 5 1 -1 0 0 0
 47 43 45 37 41 40 23 16 11 6 4 3 1 -9 -12 -4 -10 -7 -20 -30 -35 -41 -44 -50 -22 -13 -12 -6 5 2 10 15 14 21 24 26 26 32 30 36 42 46 44 41 44 45 46 44 41 56 68 70 67 65 61 56 56 55 55 56 53 52 53 51 48 49 47 48 41 44 40 38 37 41 46 50 50 47 51 54 44 46 45 42 44 42 29 22 16 8 5 2 4 -1 -1 1 -2 0 -3 -1
 42 43 43 42 45 45 24 18 13 9 2 1 -9 -12 -8 -10 -13 -10 -26 -31 -35 -42 -46 -43 -13 -8 -9 3 12 11 19 17 19 25 27 28 36 36 36 42 46 46 49 43 46 51 48 46 45 66 72 71 69 68 65 58 58 58 58 57 53 56 55 55 50 49 48 43 40 42 38 37 37 38 50 52 50 51 54 54 48 48 46 45 42 39 26 21 18 10 4 2 -1 -2 -1 1 0 3 0 -3
 44 44 40 39 44 44 32 24 20 4 1 -4 -9 -13 -6 -11 -11 -12 -26 -31 -33 -39 -43 -42 -8 -2 0 3 9 15 25 21 22 22 28 32 39 43 43 46 50 49 56 51 48 56 54 51 51 68 67 63 65 67 60 59 61 57 59 58 52 59 57 61 50 49 46 47 43 43 41 38 37 36 49 50 50 50 54 54 50 49 48 43 37 34 30 23 19 10 8 5 1 -2 -2 -3 -1 1 2 -4
 42 38 39 37 36 37 36 20 17 10 -4 -9 -8 -10 -13 -14 -19 -16 -23 -26 -27 -29 -31 -36 0 8 12 15 20 22 26 31 28 30 38 40 44 50 55 57 58 59 60 61 54 60 55 51 50 62 67 70 69 66 65 62 61 67 61 64 62 63 58 55 56 53 55 49 40 40 34 33 35 33 50 54 55 56 55 56 55 41 41 37 33 31 29 20 14 9 3 0 -2 -3 -5 -5 -5 -2 -5 -5
 35 35 32 32 33 35 19 14 10 -5 -7 -12 -10 -9 -12 -22 -22 -24 -27 -27 -28 -29 -28 -33 10 10 14 25 24 30 32 35 34 39 41 45 51 50 54 58 59 58 65 64 59 61 54 49 48 72 73 73 72 67 65 66 63 63 68 69 68 64 62 60 61 57 56 46 40 37 33 36 38 38 52 53 54 56 52 52 43 36 37 32 32 30 18 18 12 5 3 0 -2 -5 -5 -6 -3 -2 -6 -7
 31 33 33 31 27 31 18 11 3 -9 -10 -21 -20 -18 -20 -25 -28 -24 -24 -25 -24 -28 -26 -34 12 12 21 29 31 31 37 36 38 41 45 41 53 51 53 62 61 65 62 61 59 63 57 50 50 74 76 80 73 73 72 71 66 69 72 71 70 66 67 65 68 63 62 51 44 35 34 35 36 32 53 53 53 53 52 54 45 38 31 29 25 24 13 11 9 2 4 0 1 -3 -2 -9 -6 -7 -9 -10
 31 23 28 22 15 17 10 -3 -3 -13 -27 -33 -23 -25 -23 -31 -30 -27 -24 -25 -26 -26 -23 -29 17 22 26 31 37 42 41 42 46 48 53 61 52 56 60 65 69 70 66 67 65 63 61 61 55 78 77 77 79 79 74 71 74 70 68 74 75 70 71 70 71 62 62 51 40 40 36 32 29 27 52 54 54 52 47 45 43 34 33 25 20 16 11 5 7 0 0 2 0 -7 -9 -10 -15 -15 -9 -11
 19 14 15 8 8 7 -4 -8 -10 -24 -30 -34 -27 -27 -27 -33 -35 -34 -28 -27 -26 -22 -21 -21 22 26 29 36 38 42 43 43 48 57 57 60 61 61 63 67 68 72 71 69 65 67 63 64 58 82 77 78 79 78 76 77 77 78 76 75 77 75 71 69 65 58 58 52 46 40 40 34 27 29 54 53 52 48 45 42 34 28 27 23 20 16 4 4 2 0 0 -3 -4 -5 -9 -9 -14 -15 -13 -13
 17 11 5 1 0 -5 -12 -15 -17 -22 -29 -31 -28 -32 -34 -35 -36 -30 -27 -24 -29 -21 -21 -22 27 28 31 42 43 39 49 49 52 58 60 59 67 65 67 68 69 75 76 74 71 67 68 66 59 85 83 80 80 81 80 81 80 79 81 79 80 80 74 71 64 63 59 55 49 45 44 38 31 30 54 53 47 49 41 38 33 26 23 19 15 12 3 1 -1 -2 -1 0 -2 -5 -8 -5 -11 -12 -13 -14
 12 3 -2 -6 -12 -12 -14 -18 -19 -25 -33 -30 -39 -35 -27 -28 -21 -19 -17 -8 -4 -4 -9 -9 26 29 32 32 43 48 53 53 57 60 67 66 70 64 63 65 62 61 59 64 65 68 68 64 61 91 92 94 93 97 96 96 91 88 87 83 86 81 72 69 65 52 54 47 37 44 40 40 41 35 52 43 40 38 34 28 31 22 17 10 6 2 0 -4 -6 -6 0 0 -1 -7 -11 -13 -15 -22 -23 -21
 6 4 0 -7 -9 -7 -11 -17 -18 -27 -34 -36 -24 -26 -22 -11 -10 -9 0 -2 0 -5 -12 -10 27 27 28 39 44 46 50 49 54 64 71 72 63 60 60 60 61 63 67 68 68 71 68 65 63 86 88 91 92 94 95 92 88 87 85 83 83 74 71 67 54 48 47 39 36 38 43 43 42 35 44 40 37 31 31 32 21 19 12 6 4 3 -1 -4 -6 -2 1 1 -9 -11 -13 -15 -19 -22 -22 -23
 9 6 3 -4 -7 -5 -7 -9 -16 -24 -30 -32 -18 -15 -13 -2 0 3 2 3 1 -3 -1 0 32 29 31 39 42 49 52 53 55 65 70 68 65 61 61 57 58 61 67 72 72 74 71 71 72 87 86 94 97 96 99 95 91 92 84 82 81 72 69 62 54 49 42 39 41 40 41 45 38 29 44 35 34 27 29 29 24 16 8 6 6 2 -1 0 -3 -4 -3 -5 -15 -15 -12 -16 -18 -17 -23 -24
 8 4 1 0 2 -1 -4 -10 -10 -17 -20 -27 -7 3 4 6 16 18 9 11 11 5 12 8 33 35 32 39 46 44 54 57 58 65 70 74 63 59 59 57 60 64 69 72 73 76 77 74 77 87 87 90 96 98 100 98 93 91 83 79 79 69 61 56 49 42 38 41 40 39 38 36 24 24 41 31 26 25 24 26 18 10 10 6 5 2 0 -3 -5 -6 -8 -9 -15 -19 -21 -22 -26 -26 -32 -31
 5 2 1 2 4 -1 -5 -7 -6 -14 -16 -20 7 12 14 19 21 24 21 19 18 19 21 19 38 38 39 49 51 45 55 57 58 64 68 73 58 58 59 60 59 61 72 74 76 76 76 75 74 84 87 91 94 96 104 96 93 86 78 78 76 64 61 59 44 40 37 37 37 37 34 28 23 23 34 35 29 25 23 23 13 8 10 9 9 6 -1 -4 -6 -7 -9 -10 -20 -19 -20 -22 -24 -28 -33 -34
 2 0 -1 -2 0 -1 -3 -3 -3 -6 -6 -11 17 15 18 25 25 25 27 23 28 21 25 20 41 42 46 46 50 46 52 53 58 61 69 74 54 58 63 68 63 66 72 78 82 77 74 80 76 85 86 87 92 96 103 97 93 85 77 75 71 60 59 55 51 40 40 36 35 35 31 30 25 25 30 30 29 27 24 17 10 11 11 12 7 3 0 -5 -5 -4 -11 -15 -24 -22 -28 -25 -24 -31 -33 -39
 0 5 8 6 7 2 0 3 2 5 4 2 16 23 26 34 36 34 33 33 30 31 28 25 47 43 41 42 42 39 46 51 55 59 67 71 56 58 57 63 70 72 75 80 78 85 87 86 84 85 89 87 90 94 99 97 92 91 83 70 67 59 59 52 54 45 40 32 26 24 18 21 21 21 30 23 21 19 16 16 16 18 16 12 9 8 0 -6 -2 -6 -16 -21 -24 -28 -25 -30 -34 -39 -40 -39
 2 6 8 15 15 10 8 6 9 10 9 9 26 28 35 37 35 35 37 38 36 37 34 32 42 36 38 38 40 41 49 51 55 63 67 70 56 59 58 70 73 73 80 85 87 91 89 87 85 91 86 87 87 93 96 96 97 90 77 66 64 60 60 56 50 48 39 28 23 20 15 19 20 18 22 24 22 14 10 12 17 19 16 10 11 12 -3 -6 -4 -8 -17 -20 -27 -28 -30 -33 -38 -40 -39 -38
 6 9 10 16 14 17 10 13 16 13 14 18 34 36 38 41 39 34 42 45 44 42 40 41 42 39 42 33 40 42 46 48 54 58 65 62 53 55 60 69 73 77 76 80 85 93 90 89 86 92 87 80 83 87 92 97 95 88 76 68 64 59 56 51 51 41 38 21 21 19 14 14 18 20 19 18 21 11 9 6 11 11 12 9 12 6 -2 -2 -2 -6 -15 -20 -28 -27 -31 -32 -35 -38 -35 -39
 8 9 13 12 10 6 14 14 19 19 17 18 40 44 47 42 38 36 48 48 51 48 47 45 40 36 35 42 47 50 51 53 54 57 58 58 53 56 62 72 76 83 79 83 89 94 93 92 92 89 84 79 80 83 89 94 94 91 72 67 63 52 52 53 40 34 30 21 19 18 13 9 7 12 14 13 14 8 7 3 6 6 4 10 10 7 1 1 -1 -11 -14 -19 -27 -29 -30 -33 -33 -34 -38 -39
 9 11 15 9 13 12 14 15 21 30 29 30 47 48 47 43 41 44 50 47 49 48 49 49 43 44 38 47 47 45 52 51 53 57 60 59 51 54 61 72 78 83 76 86 87 94 96 94 94 93 87 80 81 80 84 93 88 91 73 64 59 50 48 46 38 38 31 23 25 23 17 12 12 15 15 16 13 8 6 3 9 7 7 9 9 7 0 1 0 -7 -13 -14 -28 -28 -30 -32 -30 -39 -40 -39
 8 12 11 13 15 14 16 16 24 38 38 37 50 52 55 44 42 44 46 45 49 47 48 47 52 51 49 50 47 50 51 50 53 61 61 59 51 55 58 75 79 81 84 87 86 92 93 97 97 93 91 82 83 82 88 84 84 84 67 62 60 49 47 46 43 42 36 26 28 22 21 22 20 18 16 17 16 6 4 2 7 6 6 6 5 6 0 -1 0 -9 -11 -17 -28 -27 -30 -34 -38 -40 -43 -44
 0 6 8 13 15 14 21 26 30 42 44 48 58 56 61 51 48 47 46 47 52 52 49 48 52 56 57 60 53 53 55 52 53 57 55 52 54 53 63 71 77 76 88 86 88 91 95 95 99 96 91 84 86 86 87 80 81 78 68 63 62 47 48 48 36 36 36 27 23 19 18 21 15 14 15 15 10 9 6 4 3 7 6 0 1 7 -2 1 -4 -10 -13 -22 -27 -29 -29 -37 -47 -45 -43 -47
 -5 -3 -4 0 4 6 7 12 9 15 10 11 11 15 18 15 17 18 16 13 14 14 20 23 26 29 28 34 39 37 46 47 46 47 42 51 56 63 64 64 63 69 71 73 73 82 84 92 97 95 83 81 74 71 66 65 59 54 53 47 46 40 34 26 25 18 12 9 4 1 -5 -9 -12 -16 -21 -19 -19 -22 -21 -20 -15 -19 -20 -21 -20 -23 -23 -29 -30 -37 -36 -36 -35 -37 -39 -39 -36 -44 -43 -46
 -1 -2 0 7 7 10 10 11 14 11 7 8 12 15 13 11 12 11 12 10 7 9 15 20 25 26 27 27 33 35 40 41 42 35 34 43 58 66 66 59 61 63 67 69 74 83 88 92 94 89 82 80 73 73 68 61 58 58 52 49 47 37 35 30 21 15 12 9 6 2 -6 -9 -13 -16 -15 -16 -20 -19 -20 -17 -13 -16 -17 -18 -17 -21 -26 -30 -32 -34 -33 -32 -34 -32 -35 -35 -40 -43 -45 -44
 0 2 2 6 10 13 12 11 19 13 10 13 10 8 11 9 10 7 8 5 1 7 13 18 22 22 27 20 25 30 34 36 38 34 38 40 53 55 52 56 58 64 70 69 77 79 84 88 88 91 85 77 68 72 66 60 59 54 49 47 42 32 32 32 22 17 16 10 5 0 -5 -10 -9 -17 -13 -14 -16 -13 -14 -15 -11 -13 -14 -16 -16 -18 -25 -29 -31 -33 -33 -32 -31 -33 -34 -29 -35 -38 -38 -39
 3 3 4 12 14 20 9 17 13 14 6 5 6 5 4 6 1 0 4 -2 -2 3 9 15 19 21 20 16 12 15 28 24 28 33 40 41 45 45 46 55 58 58 68 70 75 78 85 85 88 93 81 78 67 62 59 57 56 57 48 49 44 36 29 27 24 19 14 8 5 0 -4 -12 -12 -16 -11 -7 -9 -10 -6 -9 -8 -7 -10 -11 -10 -11 -28 -31 -30 -31 -29 -28 -32 -29 -34 -28 -29 -31 -32 -34
 4 4 9 16 17 18 17 19 16 7 3 0 4 0 5 -1 -2 -2 -4 -5 -4 4 6 7 18 21 15 9 8 11 16 20 22 35 42 41 40 41 45 56 58 61 67 67 72 79 81 85 92 91 85 78 67 59 58 52 54 52 48 52 47 29 24 27 21 18 16 8 8 2 -4 -8 -13 -13 -6 -4 -8 -6 -6 -4 -1 -4 -5 -8 -9 -13 -25 -26 -29 -26 -28 -27 -27 -31 -27 -30 -31 -29 -29 -33
 9 11 14 18 16 13 18 17 15 8 3 1 3 3 5 -6 -5 -7 -2 -5 -4 2 6 4 14 15 11 6 7 10 11 14 17 30 36 36 39 40 43 49 52 52 67 68 72 77 82 87 91 94 89 80 68 62 58 55 54 51 48 48 46 29 24 27 21 18 12 5 5 0 -2 -7 -8 -12 -3 -3 -2 0 -2 -1 2 -2 -4 -9 -7 -9 -25 -21 -23 -28 -25 -29 -25 -29 -29 -29 -31 -30 -34 -32
 11 12 13 13 18 17 19 10 3 1 -2 -6 4 -1 -4 -4 -8 -10 -9 -10 -4 -2 -1 1 10 9 8 9 9 8 6 17 20 22 28 34 35 41 47 51 52 50 63 69 73 74 79 80 90 95 79 74 70 60 61 52 54 54 53 50 45 31 26 22 17 16 14 7 2 0 0 0 0 -11 -2 1 4 2 10 9 4 5 3 3 0 -5 -19 -19 -20 -16 -14 -19 -24 -24 -22 -22 -22 -21 -25 -30
 14 17 17 17 19 19 16 10 5 -2 -4 -2 0 0 -2 -7 -9 -9 -12 -14 -9 -5 -2 0 8 8 11 13 9 9 9 11 16 20 24 32 33 37 42 50 51 52 64 66 70 72 78 78 87 83 75 74 71 63 59 54 54 54 51 48 44 29 26 19 17 15 15 6 2 -1 0 1 0 -9 4 3 4 11 15 10 2 3 1 2 0 -4 -21 -23 -20 -12 -11 -17 -25 -24 -21 -21 -20 -19 -23 -28
 10 16 16 17 20 20 19 10 5 -5 -3 -8 -3 -2 -3 -6 -10 -6 -7 -11 -10 -3 -3 -7 11 9 13 13 9 5 14 12 12 14 23 28 34 34 39 46 49 54 60 64 65 68 71 80 87 86 80 77 72 64 61 57 60 56 51 45 42 33 26 21 17 16 18 4 1 3 2 0 0 -8 8 7 5 9 12 6 5 4 2 0 0 -3 -20 -20 -14 -9 -11 -14 -21 -23 -22 -17 -15 -20 -21 -29
 13 12 12 16 19 17 17 7 2 0 -6 -3 -5 -9 -7 -7 -10 -10 -12 -11 -11 -4 -7 -6 5 10 11 13 10 6 11 11 12 16 17 19 26 32 38 44 42 48 59 57 60 62 72 73 82 85 75 75 70 65 62 59 58 59 51 39 35 32 25 22 17 13 13 5 0 0 2 -3 -2 -3 13 16 12 11 11 8 5 6 4 1 -1 -3 -15 -12 -12 -12 -11 -15 -19 -17 -14 -17 -16 -16 -21 -26
 12 11 10 16 22 19 10 7 6 -3 -7 -8 -7 -9 -8 -10 -11 -10 -11 -13 -9 -8 -10 -10 6 7 11 10 10 8 10 7 10 13 10 13 23 28 33 38 39 42 53 56 59 62 68 72 81 78 74 76 66 64 59 55 54 54 42 38 36 27 27 22 15 14 12 5 2 3 3 0 -4 -3 21 20 19 19 17 14 8 9 6 1 2 -2 -8 -9 -9 -11 -11 -15 -17 -15 -16 -17 -15 -14 -20 -25
 17 12 10 13 19 18 10 9 5 -4 -5 -8 -9 -8 -10 -14 -13 -14 -13 -9 -7 -13 -11 -12 0 4 6 6 8 14 12 9 9 14 11 14 18 22 28 36 39 42 53 55 55 60 67 74 81 79 74 73 69 67 63 55 51 49 37 36 33 28 23 18 15 13 10 12 5 6 3 2 -2 -5 25 25 20 22 20 17 9 10 1 2 0 -4 -9 -9 -3 -11 -12 -16 -15 -15 -17 -19 -13 -19 -18 -24
 17 6 0 -4 -2 -2 -9 -6 -5 -5 -6 -6 -8 0 -3 0 3 8 12 0 0 -1 -6 -7 -1 1 1 7 12 15 20 16 19 19 14 16 16 23 25 35 46 51 60 63 65 72 71 73 73 79 71 68 63 56 54 52 46 42 37 32 31 23 19 18 16 14 13 12 10 8 11 10 11 7 28 28 24 23 16 13 12 5 1 1 -2 -2 -4 0 -2 -7 -8 -10 -16 -21 -21 -19 -19 -15 -18 -22
 13 7 3 2 4 0 -5 -9 -5 -1 -3 -3 -1 -2 -1 0 0 5 1 -1 -3 -4 -8 -10 0 1 2 7 9 11 15 17 19 18 15 13 20 21 26 39 44 51 58 61 67 73 74 71 73 75 71 66 57 53 49 46 43 39 35 35 34 25 22 18 19 19 21 14 12 12 15 14 14 6 30 28 26 17 13 14 5 3 0 -2 -4 -2 0 2 -3 -6 -6 -12 -18 -20 -17 -18 -17 -13 -18 -21
 16 8 8 0 3 0 0 0 -4 0 0 0 0 0 -3 1 2 1 3 -1 -1 -4 -10 -13 -1 1 3 1 5 9 12 16 20 16 15 15 18 18 28 37 42 50 58 61 69 73 73 70 75 74 70 61 53 52 51 42 45 38 37 35 39 23 23 25 25 26 29 20 18 14 17 17 16 10 33 32 29 24 17 17 5 5 -1 0 -1 0 0 0 -5 -8 -9 -11 -16 -16 -14 -14 -15 -13 -19 -21
 12 13 8 3 4 1 3 3 2 4 6 4 1 -1 0 0 -2 2 -1 -6 -7 -6 -14 -15 -3 -2 0 1 5 2 12 12 16 18 16 17 20 29 30 39 53 57 55 67 70 70 68 65 71 69 57 54 50 47 46 47 36 37 36 39 42 25 29 33 32 32 35 24 27 22 24 21 18 16 34 31 28 22 14 11 9 8 9 0 1 0 1 0 2 -7 -9 -7 -13 -14 -13 -12 -11 -10 -15 -18
 15 14 9 9 10 9 5 4 3 7 7 2 3 0 0 -5 -2 -1 -6 -11 -8 -13 -15 -17 -8 -4 -2 1 5 5 9 8 15 15 14 19 29 35 37 49 55 57 61 66 68 66 64 63 65 58 53 51 47 47 43 37 31 32 39 40 43 33 32 31 39 39 36 32 31 27 25 23 18 18 33 29 26 17 13 9 9 8 3 3 6 0 2 0 -3 -12 -10 -5 -9 -11 -9 -11 -10 -7 -12 -17
 16 15 11 13 10 13 8 9 8 6 6 0 0 -1 -4 -6 -7 -6 -6 -11 -7 -15 -15 -14 -12 -6 -6 0 1 2 8 5 9 11 13 16 32 39 36 51 55 56 59 65 63 62 61 60 61 58 55 51 48 43 42 39 33 37 39 42 47 35 35 33 40 38 39 35 36 30 29 24 21 19 37 31 26 15 11 7 5 6 4 2 4 -3 4 0 0 -8 -8 -5 -10 -6 -9 -11 -8 -11 -12 -14
 20 19 15 19 18 15 10 12 10 9 0 0 0 3 4 1 -4 -8 -10 -14 -17 -16 -19 -19 -12 -9 -8 -10 -1 -3 2 9 12 17 19 22 34 39 39 44 48 52 60 56 58 55 55 53 57 57 51 53 45 39 40 38 41 40 41 45 46 37 38 38 38 36 39 40 40 38 31 32 29 29 40 31 26 22 12 9 6 -1 -2 -3 -7 -7 2 3 4 4 0 -3 -7 -5 -8 -14 -7 -10 -7 -9
 21 22 21 23 21 16 13 13 11 2 -1 -1 4 4 2 -1 -2 -5 -13 -17 -19 -20 -24 -20 -15 -7 -9 -4 1 2 7 9 10 16 17 19 34 39 43 45 45 49 56 56 56 52 53 52 56 54 51 46 39 38 40 42 46 43 44 45 44 39 38 36 39 38 41 40 39 34 28 31 32 30 34 30 24 12 10 11 0 -6 -4 -4 -9 -8 3 5 5 3 2 -3 0 0 -6 -12 -8 -9 -9 -7
 21 24 29 26 24 19 13 13 12 4 0 0 10 3 4 0 -1 -5 -14 -20 -21 -22 -21 -19 -15 -14 -10 -1 -2 0 1 5 14 10 13 13 36 39 44 47 50 46 54 52 55 52 52 53 56 52 52 45 38 38 41 42 44 38 46 45 41 37 37 34 36 35 36 43 37 33 26 24 31 27 28 25 22 8 8 6 7 0 0 -3 -5 -9 -2 1 0 3 0 -1 0 -3 -9 -8 -13 -9 -8 -8
 29 33 35 28 25 19 13 12 10 3 1 0 6 4 0 1 2 0 -17 -20 -21 -22 -22 -22 -18 -14 -8 -1 4 3 4 5 6 11 12 13 37 40 45 49 49 51 48 47 47 50 52 52 54 47 43 42 42 44 45 42 42 42 43 44 45 34 33 31 34 35 38 36 31 28 22 28 29 34 25 22 17 8 6 5 5 2 1 -4 -5 -8 -3 -1 0 0 -3 -4 -5 -6 -7 -7 -6 -7 -7 -8
 33 31 32 24 24 21 16 13 11 0 1 0 7 6 6 1 0 1 -12 -17 -17 -23 -24 -22 -20 -19 -17 -2 0 2 10 11 9 15 13 12 35 39 38 46 48 46 46 45 43 47 48 47 50 47 45 45 43 47 44 45 46 44 49 49 47 37 37 36 40 41 38 35 34 27 30 28 30 35 31 30 20 11 8 7 6 2 -7 -5 -4 -5 -9 -3 -5 -4 -6 -6 -5 -6 -11 -7 -8 -7 -8 -5
 30 31 31 21 19 19 13 14 12 3 1 2 8 8 8 0 -2 1 -11 -13 -15 -25 -27 -25 -21 -21 -16 -3 0 1 15 17 17 17 16 16 34 34 35 44 45 45 41 39 43 46 42 40 46 48 45 46 47 47 50 51 52 45 52 54 48 38 37 36 44 44 46 37 37 32 35 35 34 34 33 32 23 11 10 13 3 1 -5 -5 -6 -8 -5 -5 -3 -10 -11 -9 -8 -7 -7 -6 -5 -6 -7 -7
 30 28 24 23 18 20 18 16 13 9 7 7 10 7 7 0 1 0 -7 -10 -14 -22 -26 -28 -24 -20 -16 -4 1 3 15 17 18 21 23 20 31 33 32 37 39 43 41 39 40 44 43 43 50 48 49 49 49 50 51 45 49 46 47 51 49 44 43 43 48 48 48 43 44 37 40 42 36 37 34 29 27 16 17 17 6 0 1 -9 -5 -8 -4 -8 -1 -5 -11 -12 -14 -8 -12 -8 -5 -7 -4 -6
 26 23 19 22 21 21 19 14 11 8 1 -2 -6 -10 -13 -12 -16 -14 -23 -21 -20 -23 -21 -24 -25 -20 -14 -14 -12 -15 -14 -12 -12 -8 0 0 0 14 20 25 33 32 29 32 37 38 42 46 49 53 49 45 44 32 33 30 33 30 28 26 27 21 22 19 19 20 26 27 28 31 31 29 22 26 29 27 25 28 14 16 11 9 4 8 7 4 2 0 -1 -1 -4 -3 -9 -8 -3 -1 0 0 -4 -9
 20 19 20 18 20 16 9 10 8 4 4 -1 -6 -6 -11 -12 -13 -18 -16 -19 -16 -14 -15 -22 -17 -16 -13 -6 -7 -6 -10 -8 -4 3 3 5 15 24 25 37 38 34 30 31 33 38 42 46 50 54 51 50 40 33 32 38 39 36 28 27 24 21 24 18 17 20 23 21 23 25 29 23 18 23 27 24 29 19 6 7 7 8 10 7 6 5 5 4 4 3 0 -3 -6 -6 -3 1 2 2 -3 -10
 18 19 19 14 13 7 7 6 6 2 2 -1 -5 -8 -10 -15 -14 -16 -10 -15 -11 -17 -13 -22 -10 -8 -3 0 -2 -3 -1 -3 -2 9 7 9 17 28 29 39 39 36 30 34 38 40 45 48 54 48 52 49 41 39 37 39 39 41 32 31 29 21 21 14 17 15 22 21 25 27 25 23 24 21 30 26 27 19 11 7 10 9 15 5 8 2 4 9 4 6 6 -1 -3 0 3 2 1 2 -1 -7
 21 16 13 9 6 1 1 3 7 0 -2 -2 -6 -8 -4 -7 -8 -4 -12 -10 -7 -11 -11 -17 -6 2 5 5 6 3 -1 2 8 11 22 22 25 33 35 40 36 38 37 41 46 46 52 55 55 51 47 49 46 44 41 44 41 39 39 35 32 19 18 14 12 19 15 20 21 23 22 20 22 21 33 29 28 20 13 9 11 10 8 8 3 3 9 7 11 9 6 6 0 6 3 3 2 0 -3 -6
 16 12 11 2 2 -3 -4 -1 -2 -4 -3 -6 -8 -11 -8 -8 -8 -10 -8 -10 -10 -9 -5 -13 0 5 6 8 5 9 5 4 7 18 23 25 34 37 41 38 37 40 42 47 50 50 57 58 55 47 47 47 47 49 49 45 40 40 38 36 34 22 22 16 16 23 17 18 23 25 24 21 21 18 29 30 30 20 16 9 10 7 8 1 0 1 11 6 10 8 7 7 5 8 6 0 0 0 -3 -8
 13 7 6 -5 0 -8 -8 -5 -9 -12 -6 -4 -10 -9 -7 -8 -6 -9 -6 -5 -8 -12 -6 -14 -1 4 7 16 9 15 18 10 8 25 25 28 39 40 45 45 41 47 47 51 51 55 54 56 53 46 45 50 51 52 52 45 46 44 43 37 32 21 22 13 18 19 14 14 20 21 23 22 19 15 25 30 32 21 20 12 8 5 5 5 0 -3 8 10 10 8 7 0 6 4 2 -4 -1 -1 -6 -5
 9 2 -2 -1 -5 -5 -14 -7 -5 -6 -3 -3 -5 -5 -2 -3 0 1 -2 -4 -7 -6 -7 -7 0 4 10 11 13 12 18 28 26 31 37 39 40 45 46 45 52 52 50 54 52 53 54 51 57 43 44 47 53 54 52 51 44 41 42 37 34 24 22 21 17 17 14 15 10 3 5 5 -2 1 30 21 15 13 11 8 6 2 0 -4 -4 -3 11 10 11 12 9 9 2 -1 -1 -2 0 -1 -5 -6
 8 5 5 4 -1 -6 -4 -3 -3 -2 -2 -1 -2 -3 -2 0 2 1 0 -1 -2 -3 -4 -6 0 1 5 13 14 18 26 31 33 38 42 44 51 52 51 54 57 52 54 51 53 51 48 48 52 36 39 47 48 49 45 42 42 38 38 38 39 26 26 23 18 16 10 11 7 6 5 3 -2 -1 24 20 16 12 11 12 3 2 1 -2 -4 -2 12 12 13 11 11 9 1 0 -2 0 1 -1 -3 -5
 12 6 2 5 2 0 -1 0 2 3 0 1 0 0 1 0 3 2 -3 -1 -3 0 -4 -9 4 3 6 16 17 22 27 32 40 43 45 45 54 55 54 57 58 54 51 51 54 53 50 50 48 34 39 48 44 46 48 36 38 38 39 38 35 28 25 22 18 14 8 12 11 8 3 1 -1 -4 24 21 13 12 11 11 2 2 0 -2 -4 1 14 14 14 7 7 5 0 1 -1 0 -4 -3 -2 -7
 11 17 12 9 9 7 0 5 3 8 5 9 1 5 3 3 3 5 0 0 -3 -2 -2 -3 6 13 15 19 22 28 29 41 39 49 52 57 62 63 65 62 64 59 56 55 55 60 59 56 57 33 35 31 39 39 39 35 33 36 39 40 41 24 23 19 17 10 9 12 5 0 -1 0 -8 -11 26 20 12 10 11 15 4 3 0 1 6 7 11 9 4 2 1 0 0 0 -5 -1 -2 -9 -6 -8
 20 21 15 12 13 12 5 4 5 7 7 7 9 11 6 4 5 2 1 1 2 0 -3 -2 13 16 17 23 23 24 33 38 45 54 56 59 67 67 70 67 69 65 63 59 59 66 63 58 56 29 30 28 32 37 37 33 35 39 42 40 40 28 24 23 14 11 7 5 0 -2 -7 -10 -11 -13 22 22 18 16 13 11 6 1 2 7 9 8 11 9 6 3 4 0 0 -1 -1 -4 -7 -11 -9 -5
 20 21 20 10 11 16 12 8 3 3 6 11 9 9 6 9 3 3 0 1 1 2 0 -1 11 19 18 23 23 29 32 41 44 52 60 62 68 70 71 67 73 70 65 66 68 67 67 63 57 19 22 17 29 30 32 34 37 38 37 42 42 30 27 24 13 8 8 3 -4 -7 -12 -10 -16 -14 25 20 20 20 14 10 8 8 6 11 9 8 12 7 7 4 3 -1 -2 -2 -2 -3 -6 -8 -6 -2
 22 16 16 17 16 16 18 15 15 15 14 11 9 13 12 12 20 15 14 13 12 6 7 6 17 22 25 29 35 37 42 50 55 55 64 65 71 69 66 70 70 72 71 70 69 72 71 65 61 17 26 33 33 36 38 37 33 32 31 32 39 35 24 23 20 10 7 4 0 -4 -9 -12 -15 -15 23 19 14 12 10 3 2 9 3 7 7 8 9 8 13 11 6 2 9 6 3 0 0 0 -3 -3
 11 9 12 13 16 17 18 17 17 15 12 12 14 13 14 18 22 20 20 16 12 9 8 7 18 21 22 32 34 39 48 52 53 60 62 67 70 68 67 73 69 74 73 72 74 75 68 65 64 24 27 31 34 37 38 34 29 28 30 30 33 27 23 21 11 6 6 1 -1 -5 -10 -12 -16 -19 18 16 14 11 11 6 6 9 7 4 8 10 12 8 10 6 1 8 2 1 -3 -2 0 0 0 -1
 8 9 8 13 12 18 21 18 20 17 16 11 14 15 15 21 26 27 21 19 14 9 8 6 15 20 20 36 38 50 52 52 54 62 66 70 76 71 71 75 77 81 77 77 76 76 72 67 63 31 31 36 36 37 39 29 27 22 28 30 31 26 21 20 10 8 7 -2 -2 -6 -10 -13 -15 -17 13 8 8 9 7 2 9 9 1 9 10 13 15 12 11 9 5 6 1 -2 -4 -4 -6 -3 -1 -2
 8 5 6 9 15 17 23 23 19 17 11 14 16 17 20 22 30 30 28 23 17 10 13 12 11 17 19 33 44 53 50 58 58 65 71 74 74 71 72 80 80 83 82 81 81 80 78 74 69 35 35 36 36 36 34 28 24 28 27 29 28 26 24 23 14 6 7 1 -2 -6 -12 -7 -13 -12 8 4 4 2 1 0 4 10 10 9 14 16 19 18 14 11 4 3 -1 -3 -5 -5 -4 0 4 3
 5 7 6 11 15 23 25 22 22 15 10 10 19 22 23 34 35 36 29 26 20 14 15 12 15 18 25 40 47 51 56 60 61 70 72 72 70 68 73 80 77 83 85 81 80 82 80 76 71 37 37 37 38 37 34 26 25 27 27 30 28 25 25 22 11 5 0 0 0 -7 -9 -13 -14 -16 2 2 3 2 0 -2 8 13 9 12 17 15 19 18 13 4 2 0 -4 -2 0 -3 0 0 1 4
 6 7 4 16 16 22 25 23 24 18 13 13 22 26 24 38 38 44 36 30 25 16 15 15 12 17 29 42 46 51 61 62 62 72 70 75 73 72 78 86 82 92 85 84 82 83 76 75 70 42 37 34 32 36 31 28 26 26 21 26 24 29 26 21 10 8 4 1 -1 -9 -8 -13 -13 -15 5 1 7 0 2 0 8 5 0 11 11 12 14 13 9 5 3 -3 -1 -3 -2 0 1 2 1 8
 3 6 11 14 21 20 26 21 19 16 18 18 23 27 27 28 33 39 38 31 33 29 25 19 12 27 33 41 46 50 61 63 66 63 70 72 72 76 77 78 81 86 86 79 75 73 71 72 66 43 43 38 36 32 29 30 30 28 31 25 30 28 18 17 17 10 2 0 -5 -9 -14 -13 -18 -18 0 -5 -4 -5 -2 -1 2 7 5 7 10 10 13 10 7 9 5 1 -3 -1 -1 0 3 7 3 10
 2 3 9 18 21 24 21 23 20 23 25 21 25 26 27 28 31 34 36 30 28 28 27 22 24 29 36 45 47 52 58 63 64 64 71 75 73 76 77 78 77 80 79 75 73 70 74 73 72 50 48 44 37 33 33 31 32 33 29 23 23 24 19 17 20 16 9 2 -2 -9 -13 -19 -20 -21 -5 -10 -10 -7 -7 -3 2 9 8 7 8 9 11 9 9 7 5 -1 -5 -2 -2 4 8 9 7 8
 8 3 4 16 15 19 21 25 21 22 25 21 22 23 20 26 27 32 36 32 23 27 26 25 27 33 43 49 50 53 54 58 59 57 69 72 77 77 76 80 76 77 84 75 68 67 70 74 71 49 50 48 43 39 32 35 31 34 33 27 26 26 23 27 19 17 14 8 0 -7 -14 -16 -18 -17 -2 -10 -12 -11 -8 -4 0 6 6 6 7 10 12 11 16 8 5 -2 -6 -2 2 6 4 9 8 8
 3 6 8 14 17 17 22 25 25 22 23 22 22 21 22 26 30 30 34 31 29 21 21 20 35 36 41 52 54 56 50 48 52 63 65 71 73 74 74 78 78 77 74 72 70 66 65 67 68 54 54 53 41 38 33 33 34 34 31 28 25 26 27 28 22 17 16 2 -3 -9 -15 -14 -15 -16 -6 -7 -12 -10 -7 -4 1 3 7 8 8 9 15 19 17 8 3 0 -2 1 3 5 1 0 5 7
 3 4 8 11 19 21 22 22 18 22 23 27 20 20 24 28 30 34 30 31 29 27 27 26 35 39 42 48 51 47 49 51 52 66 70 76 76 77 75 74 74 71 71 71 69 68 68 71 71 57 50 52 47 38 34 34 35 38 25 26 25 23 23 23 20 19 16 8 3 2 -12 -12 -10 -12 -4 -9 -5 -10 -8 -5 -4 0 1 6 4 5 15 13 16 2 1 -3 -2 1 2 6 4 -3 -2 4
 3 7 9 18 20 16 16 16 18 18 19 22 25 24 26 29 32 29 28 28 29 31 32 28 39 44 45 46 46 48 52 53 51 71 75 75 79 80 75 72 71 72 72 72 71 73 74 73 74 55 54 52 41 39 37 39 39 39 29 25 22 22 21 22 21 19 19 10 8 1 -6 -6 -7 -10 -8 -7 -10 -8 -6 -4 -4 -5 -3 4 4 5 11 10 8 1 0 -2 -2 0 6 7 -3 -11 -4 2
 0 5 3 15 17 17 13 16 12 18 19 24 30 29 28 28 30 28 28 25 22 28 31 25 37 40 37 42 45 46 50 53 54 67 72 69 77 77 71 71 69 74 69 67 74 76 72 72 76 61 60 54 43 43 37 37 37 34 30 25 21 19 19 22 16 22 15 7 12 8 1 -1 -1 -1 -5 -9 -8 -6 -7 -1 -1 0 1 4 5 6 11 8 2 0 -4 -8 -2 0 3 4 4 -5 0 1
 1 3 7 10 10 14 15 15 13 16 19 24 30 32 33 29 27 27 24 22 23 27 28 29 35 39 42 41 42 43 49 53 55 60 65 69 73 73 71 68 66 66 66 68 71 74 75 73 74 67 66 59 47 43 39 34 35 35 30 27 24 20 20 20 20 19 19 17 14 13 8 2 2 -2 -8 -8 -9 -7 -5 -4 0 0 3 4 5 7 9 7 2 -3 -4 -10 -7 -4 0 3 2 1 0 0
