 0 -2 -3 -6 -10 -7 -4 -5 -5 -5 -3 0 -4 -5 -3 -3 -5 -1 0 0
 0 -3 -4 -5 -9 -8 -8 -9 -8 -9 -10 -6 -9 -9 -7 -5 -7 0 2 0
 2 -2 -5 -7 -6 -10 -13 -13 -14 -15 -16 -14 -14 -10 -11 -8 -4 -3 -1 0
 3 3 -2 -4 -7 -10 -12 -15 -15 -15 -17 -22 -22 -23 -19 -13 -8 -7 -3 0
 5 3 0 -2 -5 -9 -13 -17 -17 -17 -20 -23 -27 -30 -26 -18 -10 -7 -6 -2
 0 1 -1 -4 -11 -10 -18 -20 -20 -20 -23 -24 -26 -27 -26 -20 -17 -11 -10 -5
 -1 -3 -4 -9 -14 -16 -21 -24 -25 -21 -22 -24 -25 -25 -24 -24 -22 -12 -10 -5
 0 -1 -5 -9 -12 -16 -20 -21 -23 -22 -21 -22 -22 -23 -21 -21 -18 -11 -8 -6
 -5 -3 -4 -11 -10 -16 -15 -21 -21 -22 -22 -22 -21 -24 -20 -17 -20 -14 -12 -8
 -4 -5 -9 -9 -12 -15 -16 -22 -22 -22 -20 -15 -10 -16 -12 -12 -10 -9 -8 -10
 -3 -7 -8 -8 -12 -9 -16 -17 -22 -23 -19 -13 -11 -8 -8 -6 -6 -3 -3 -3
 -4 -8 -9 -9 -12 -11 -13 -15 -14 -21 -16 -11 -8 -4 -4 -1 -2 -1 0 0
 -7 -7 -7 -6 -9 -10 -11 -12 -14 -18 -14 -9 -5 -5 0 -3 -2 0 0 0
 -7 -8 -5 -5 -10 -9 -10 -13 -16 -19 -18 -13 -6 -5 -1 -1 0 0 3 2
 -6 -7 -6 -8 -7 -8 -10 -15 -11 -21 -17 -14 -2 4 0 0 0 0 2 3
 -5 -7 -3 -3 -5 -14 -16 -15 -14 -15 -11 -10 -4 -7 -1 -1 -2 0 3 4
 -3 -1 0 0 -3 -10 -20 -14 -12 -8 -7 -8 -7 -9 -4 -3 -4 0 2 3
 -1 1 2 1 -2 -5 -10 -12 -9 -2 -5 -6 -6 -7 -3 -1 -1 1 2 2
 -2 3 1 3 1 3 -1 -4 -1 -3 -2 -1 -4 -11 -5 -2 0 0 -1 1
 1 2 1 3 4 6 4 2 0 -1 -3 -3 -5 -6 -5 -3 -2 -2 0 0
