 0 2 0 1 2 1 4 7 9 9 8 5 1 -1 2 2 1 2 0 0
 0 0 3 1 4 3 6 6 7 12 11 5 3 5 2 1 3 4 0 0
 -1 0 4 3 5 8 8 5 5 15 12 8 11 8 3 5 4 1 0 0
 -5 2 0 3 4 6 7 7 7 18 13 12 14 12 5 6 4 0 1 -1
 -8 -4 -2 0 2 1 4 6 8 18 19 18 13 13 10 6 4 2 -2 -1
 -11 -7 -4 0 1 4 4 7 11 16 15 15 10 11 9 6 7 2 1 -2
 -15 -10 -4 0 3 4 3 12 15 12 10 11 11 10 9 8 7 0 -3 -5
 -11 -7 -3 3 9 11 10 12 13 12 11 9 10 10 3 1 -1 -6 -7 -8
 -10 -5 0 4 14 13 14 15 18 12 9 10 8 8 3 0 2 -6 -5 -9
 -12 -9 -7 -1 3 4 6 9 14 12 10 5 8 5 5 1 -1 -3 -6 -8
 -9 -11 -2 0 4 7 8 9 10 16 12 8 12 10 10 6 6 3 0 -3
 -8 -2 3 2 7 8 8 7 8 16 15 13 15 14 15 15 13 6 1 0
 -4 -2 5 6 7 10 8 8 9 16 16 15 16 16 16 12 8 5 4 -1
 -2 -1 3 7 8 8 8 8 12 19 22 15 19 19 16 11 6 5 0 -1
 -2 0 -1 0 5 7 10 11 8 18 22 24 22 20 21 18 13 8 3 0
 -2 -4 -3 0 2 8 8 9 5 16 19 22 16 16 15 12 12 7 2 -1
 0 -1 -5 -2 0 4 7 8 5 14 18 20 11 12 8 10 10 2 0 -2
 -1 -4 -1 0 0 2 8 10 7 11 11 10 7 5 4 2 3 1 0 -2
 -1 -2 -4 -4 -1 4 6 7 6 6 1 3 3 2 4 3 1 3 0 -1
 0 -1 -1 -1 0 2 3 2 5 4 1 1 0 0 0 0 0 0 -2 0
