 0 -1 -2 -6 -10 -11 -11 -11 -12 -11 -8 -8 -6 -2 0 2 1 0 -1 1
 -2 -4 -5 -7 -8 -8 -8 -7 -4 -9 -9 -8 -5 -4 -3 0 -3 0 1 1
 -4 -6 -8 -4 -6 -4 -6 -2 -2 -7 -8 -10 -5 -2 -4 -3 -3 -1 0 0
 -4 -6 -6 -2 -3 -4 0 2 5 -6 -7 -8 -5 -5 -4 0 -2 0 1 2
 -7 -8 -7 -4 -2 -1 -2 2 3 -5 -6 -5 -4 -2 -4 -4 -2 0 3 1
 -7 -5 -7 -4 0 -3 0 3 4 0 0 -3 -3 -5 0 2 3 5 4 0
 -5 -5 -8 -2 1 2 2 3 0 4 2 0 0 0 0 5 9 3 1 1
 -5 -6 -3 2 2 3 4 4 5 5 4 2 1 0 3 3 5 3 1 0
 -4 -5 1 2 7 5 2 5 4 3 6 6 1 2 0 4 0 0 0 0
 -5 -2 0 0 1 1 2 6 7 6 8 11 10 8 10 9 4 1 0 1
 -7 -2 2 0 2 6 6 9 10 3 9 6 7 9 10 5 0 -2 0 0
 -7 -2 1 2 5 7 7 6 11 2 2 3 9 9 11 1 -7 -4 -2 1
 -6 -2 3 6 7 7 3 5 2 1 2 8 9 7 7 0 0 -1 2 2
 -6 0 1 0 5 3 4 4 5 2 6 6 8 6 4 4 0 0 3 0
 -6 -2 2 4 3 0 -4 -2 -1 2 4 4 5 7 7 2 0 0 2 0
 -7 -2 0 3 -1 -1 -2 0 -1 -1 0 1 2 1 5 2 2 1 2 -1
 -5 -5 -1 0 -6 -2 0 -1 -5 -4 -3 -2 2 3 1 4 6 0 0 -2
 -3 -4 -3 -4 -9 -8 -3 -2 -2 -4 -4 2 5 3 0 4 4 1 1 0
 -4 -4 -6 -8 -8 -8 -6 -4 -4 -4 -3 -3 2 0 1 3 3 1 0 0
 0 -4 -6 -9 -11 -11 -7 -4 -2 -3 -3 -3 -3 -3 -1 1 0 0 0 0
