 0 0 -1 0 2 3 2 10 8 12 12 10 1 6 6 6 8 4 4 0 -7 -8 -6 -6 -11 -4 -4 -5 -8 -14 -13 -9 -9 -8 -4 -5 -2 9 19 25 32 36 42 42 42 42 44 46 48 52 56 59 56 53 48 46 45 46 45 36 35 34 29 26 24 29 32 34 36 36 35 35 35 31 27 24 24 23 15 13 7 -1 -4 -4 -2 0 1 2 1 3 3 1 0 0 2 3 0 6 9 4
 -1 0 0 5 5 4 9 13 12 16 11 7 5 7 6 8 6 6 1 0 -4 -8 -6 -8 -2 0 -2 -3 -8 -9 -4 -5 -5 -1 -1 -3 6 11 18 30 32 36 41 40 42 40 43 46 47 59 63 62 58 55 52 48 49 48 40 33 34 33 28 24 26 28 30 34 37 34 33 34 35 33 25 22 23 19 15 14 2 -2 0 -2 -3 0 4 2 4 6 4 1 3 0 5 3 7 8 9 10
 -1 -2 0 6 7 9 13 14 17 18 12 8 5 5 5 4 5 3 1 -2 -3 -10 -9 -16 0 -1 -1 -1 -4 -8 -5 -5 -5 2 1 -4 7 17 22 33 34 41 47 40 39 40 47 46 55 63 63 63 62 54 54 54 51 47 42 39 34 30 26 26 21 26 29 34 36 38 33 30 36 31 30 29 29 22 17 11 3 0 1 1 2 0 9 9 8 9 5 5 4 2 4 6 4 9 12 13
 -5 -1 1 5 10 13 14 24 25 20 16 12 7 9 9 8 4 10 1 -4 -7 -10 -8 -12 2 4 5 0 4 4 0 4 -2 0 3 3 16 21 25 34 40 40 47 43 41 39 43 46 47 63 62 63 60 61 62 50 50 51 47 36 33 29 25 23 21 27 23 32 33 32 28 31 29 33 30 31 28 23 12 9 2 2 6 4 10 11 15 13 12 10 5 7 9 9 9 12 13 14 17 16
 -3 0 3 9 13 17 25 26 26 23 22 18 11 12 10 6 4 7 0 -4 -4 -5 -6 -7 8 7 6 10 13 8 8 8 5 3 1 1 22 22 25 39 41 45 46 42 40 39 43 46 44 63 65 66 63 62 58 49 44 48 39 35 32 25 24 21 22 26 27 30 33 31 25 26 28 30 27 29 25 16 10 6 3 4 4 8 12 13 16 14 13 5 5 2 8 10 12 14 16 16 18 19
 -1 3 8 9 17 19 27 27 25 22 25 24 11 12 4 8 6 6 3 0 -4 -3 -6 -11 14 13 13 13 12 11 13 11 9 6 7 6 22 25 28 42 45 52 48 47 45 42 44 43 43 63 65 67 66 65 62 52 48 46 36 33 25 22 25 21 22 28 23 28 26 27 22 24 25 31 27 26 24 13 8 5 0 3 5 4 12 14 14 13 14 9 7 2 6 13 15 18 21 20 22 19
 -4 -1 5 11 20 24 25 23 24 22 22 24 11 16 14 12 10 11 4 2 0 -5 -7 -6 13 16 12 13 13 12 15 17 16 13 16 13 27 34 40 38 50 52 53 54 52 47 45 44 44 67 66 64 67 61 58 55 40 38 34 26 26 23 24 23 24 22 21 21 26 31 31 27 31 29 24 16 11 6 3 -2 1 2 3 6 8 13 15 10 6 4 12 7 12 15 19 18 22 26 24 23
 -11 -6 2 17 23 24 19 20 20 16 17 21 18 23 21 15 13 7 4 4 -2 -6 -5 -6 16 16 15 13 13 16 21 21 18 18 18 18 33 37 38 45 53 54 56 55 49 45 46 44 41 68 68 65 57 56 55 42 35 35 24 22 20 20 23 22 19 20 23 28 31 27 31 32 29 33 20 18 12 5 4 0 3 3 6 9 6 12 18 16 11 21 24 16 15 16 18 16 20 26 26 23
 -10 -5 2 11 17 21 19 15 12 18 16 16 18 22 22 15 14 6 4 1 -1 -4 -4 -5 17 18 9 19 14 18 27 23 22 22 25 24 32 35 34 42 49 52 52 53 50 42 36 41 39 71 66 62 58 54 52 40 35 31 24 21 20 18 18 18 18 20 21 31 30 30 30 33 32 31 20 19 15 7 5 5 8 8 5 10 10 11 22 20 17 25 20 16 14 17 20 18 24 24 19 23
 -8 -2 5 8 10 10 11 4 5 11 17 18 22 24 24 18 12 4 1 0 -2 -4 -3 -4 18 17 10 17 28 32 30 29 23 26 36 36 33 33 32 41 50 51 53 46 45 38 34 36 30 68 60 56 53 50 49 41 30 29 19 12 9 14 13 12 17 21 26 25 28 29 30 34 37 41 23 18 11 9 10 11 10 14 11 17 20 27 25 27 29 23 17 15 19 25 25 21 24 22 23 22
 -5 -4 -3 5 7 10 2 -1 5 13 13 20 23 25 23 15 15 8 6 4 1 -1 -2 -3 21 21 18 29 33 34 32 32 31 39 41 38 39 36 39 47 51 53 46 44 40 35 35 36 35 64 60 56 52 49 46 31 25 22 12 10 9 9 9 8 16 16 22 26 29 30 30 34 35 37 21 18 14 15 12 13 15 17 19 25 23 26 32 30 29 19 16 15 22 25 21 20 22 24 23 23
 -6 -5 -5 1 0 0 3 1 6 12 12 19 23 22 22 16 12 12 9 8 5 2 4 1 27 26 32 35 36 36 40 41 37 45 43 45 40 43 43 42 49 50 44 42 39 33 34 30 35 71 63 58 57 49 44 28 26 17 11 11 7 8 9 10 15 18 21 29 29 32 32 32 35 37 16 18 17 15 17 17 19 25 26 30 29 32 34 33 32 21 19 19 19 22 20 18 19 23 20 23
 -7 -5 -4 -2 2 6 11 20 19 21 20 23 21 20 19 15 14 12 10 12 11 8 8 4 28 35 35 39 41 44 43 43 44 46 45 46 47 35 31 31 27 26 28 31 29 32 29 28 30 71 73 67 65 56 55 52 43 37 30 20 17 6 15 16 17 18 15 12 13 19 17 24 24 30 19 24 21 27 22 26 27 30 33 34 40 39 36 36 38 34 33 35 34 31 24 27 24 27 28 24
 -3 -6 -4 0 5 8 19 25 26 19 20 22 23 20 20 20 20 17 15 11 12 11 8 7 33 36 39 36 36 35 38 42 44 42 43 45 34 32 31 26 26 27 27 28 30 32 31 27 23 76 77 73 62 53 51 49 45 37 26 20 16 16 20 19 24 19 14 9 9 10 18 21 23 29 17 21 20 19 21 24 29 28 31 38 41 42 40 41 39 33 31 34 37 34 29 33 30 28 26 27
 1 -6 -4 0 5 11 19 25 17 19 26 22 25 22 18 23 21 24 18 16 14 17 10 5 34 37 43 37 36 37 41 41 46 44 43 47 32 28 26 24 28 27 26 27 31 31 30 29 22 80 79 79 65 58 56 52 46 37 26 24 18 18 26 27 21 20 14 7 9 12 12 15 23 28 9 15 14 13 18 24 28 28 31 36 41 44 39 38 42 36 35 39 43 37 36 39 36 36 30 29
 0 4 2 0 9 15 19 18 20 23 24 26 24 20 26 26 29 32 24 23 24 16 13 8 36 37 39 38 37 31 39 35 39 44 45 49 28 27 25 28 32 31 25 27 30 29 27 22 18 80 83 79 70 61 57 49 41 36 31 28 25 28 30 28 23 15 9 7 12 12 11 13 21 20 5 10 9 12 18 17 28 31 29 39 46 44 38 40 38 39 40 45 41 46 46 46 47 45 40 36
 5 9 6 7 9 13 18 18 21 25 23 27 24 21 24 31 33 34 29 23 22 20 18 9 40 42 38 39 39 33 29 28 33 45 49 49 27 29 28 33 35 30 25 24 24 27 26 21 21 88 86 81 67 60 56 46 42 37 34 32 27 33 33 32 18 15 12 11 14 14 14 17 21 21 1 9 8 16 21 20 30 35 38 45 50 44 39 41 40 39 40 43 52 56 53 48 45 48 43 40
 5 8 9 8 12 10 19 20 26 25 27 27 23 25 25 34 35 37 43 29 25 22 19 10 44 42 41 34 35 30 25 27 35 43 44 47 24 28 30 32 33 30 25 26 24 26 24 18 19 89 83 77 64 62 57 49 46 36 37 35 30 34 29 24 16 12 11 6 12 17 14 21 16 13 0 3 4 10 19 22 27 30 37 46 49 49 34 38 41 35 41 44 55 56 52 54 54 49 46 45
 6 6 4 9 9 13 21 25 30 29 31 33 26 31 33 35 37 40 43 38 34 31 26 21 46 41 37 37 29 24 24 27 29 35 38 44 27 29 28 31 28 29 26 23 22 17 13 13 11 86 84 77 70 65 58 50 50 48 45 39 33 36 31 27 26 18 14 6 10 9 5 1 0 3 -5 -2 3 8 13 15 28 31 33 36 40 44 35 40 41 45 51 50 54 51 52 57 56 53 51 51
 2 1 6 8 10 13 24 26 28 29 29 32 32 32 35 37 36 42 42 41 39 36 32 27 42 39 40 35 30 26 28 27 31 32 35 39 27 31 31 29 26 24 24 24 21 17 16 14 12 87 87 78 69 68 62 57 53 51 45 39 35 32 29 27 22 20 13 5 5 4 0 0 -4 -1 -5 -3 2 9 12 16 25 28 32 33 38 43 40 39 42 49 54 56 55 54 53 61 57 51 53 55
 7 3 10 9 11 15 24 29 27 29 29 32 34 39 38 42 42 48 44 50 45 42 38 33 48 42 42 34 30 27 27 24 28 33 34 34 24 33 29 29 24 27 23 22 22 14 19 14 14 90 82 78 70 67 61 61 57 56 49 46 39 35 30 30 19 17 8 0 -1 -3 -7 -8 -5 -5 -7 -5 -2 9 12 18 22 23 25 31 35 37 45 42 45 53 55 56 59 57 63 66 63 62 59 61
 6 9 9 13 20 21 25 32 31 33 35 32 41 46 45 47 52 52 47 50 54 46 42 37 49 49 44 37 30 26 25 27 26 28 29 35 27 21 24 27 26 22 21 17 13 12 11 9 10 86 80 79 70 71 69 64 63 61 55 51 48 34 32 30 19 12 5 -2 -10 -9 -12 -10 -15 -12 -12 -5 -1 5 8 13 18 23 25 29 43 46 49 51 49 49 57 62 61 66 68 74 73 83 75 75
 7 9 13 19 21 23 27 30 32 36 39 38 46 47 47 53 56 52 52 50 51 45 43 42 48 49 42 34 29 28 28 27 25 26 24 26 21 16 20 22 25 22 17 15 10 10 8 7 4 86 82 80 77 75 71 70 68 60 53 52 48 36 33 29 16 14 7 -10 -14 -14 -13 -12 -15 -13 -8 -5 -3 1 3 9 18 25 26 34 41 44 52 53 54 56 59 61 70 73 76 79 84 87 83 81
 6 8 10 19 20 19 27 29 32 39 43 40 46 49 49 52 54 53 51 51 47 48 46 45 45 44 35 35 32 28 21 24 28 25 23 21 18 18 19 21 21 17 9 11 13 7 6 6 6 85 84 80 79 76 77 69 66 60 52 53 48 39 34 23 18 12 3 -13 -13 -14 -16 -18 -17 -12 -15 -8 -5 1 4 9 16 23 21 31 41 49 53 56 55 64 60 64 73 77 84 86 93 89 92 90
 6 15 19 24 24 24 27 33 31 35 31 34 35 36 33 32 34 40 38 44 49 49 50 50 44 37 37 41 36 35 35 28 27 23 21 14 16 17 16 16 13 14 15 19 19 18 16 18 17 86 83 80 79 70 66 61 60 54 56 47 46 42 45 46 39 31 27 30 19 12 7 2 -3 -10 -13 -2 -2 3 14 19 24 29 28 35 41 41 43 47 51 45 50 50 56 70 75 82 85 87 89 97
 9 15 21 26 27 28 33 34 33 30 31 31 35 38 35 33 33 35 40 44 48 49 48 49 38 35 37 37 36 37 31 28 24 21 21 17 15 18 18 14 12 9 17 18 18 18 18 19 15 83 83 81 74 68 64 61 62 60 56 48 49 52 53 46 36 30 31 27 23 12 8 2 -2 -8 -7 -2 2 9 16 22 30 29 36 45 49 49 48 51 52 54 56 58 69 71 75 83 83 85 89 94
 11 18 23 30 28 24 36 34 36 32 32 31 33 35 37 31 29 31 36 41 43 45 45 53 35 38 38 38 37 38 31 26 28 16 17 18 16 15 16 14 10 13 14 14 12 16 20 17 9 79 83 79 73 66 68 61 63 62 59 56 52 58 54 48 41 39 36 25 23 15 12 8 0 -4 -5 -5 1 10 17 26 32 33 41 44 51 54 60 54 51 62 61 65 72 74 72 81 86 83 83 90
 11 21 20 29 33 35 35 34 32 32 30 30 31 30 28 28 24 25 32 40 42 41 46 48 37 37 42 37 35 37 30 25 20 17 11 9 13 12 14 12 12 9 10 12 17 13 9 10 7 81 79 77 70 62 57 64 62 66 63 64 65 60 51 47 46 45 41 29 25 20 18 11 11 4 -8 -2 1 14 21 30 32 39 47 50 54 61 58 58 55 63 70 72 75 80 80 78 76 76 81 83
 16 19 23 32 34 35 36 35 36 31 31 33 29 28 28 25 23 21 34 42 42 42 45 49 38 39 36 34 33 34 28 26 22 16 12 9 11 10 11 12 13 10 12 12 15 10 10 10 9 78 80 75 61 59 56 58 58 61 64 68 64 58 50 49 48 45 43 32 26 22 22 18 13 4 -3 -1 8 20 20 31 39 41 44 53 54 61 62 61 63 73 72 77 85 83 82 79 79 76 80 79
 12 17 22 27 36 41 41 36 31 31 29 30 31 31 26 25 21 18 26 37 39 43 46 49 40 38 33 29 32 29 24 25 21 16 11 6 13 10 12 12 13 12 13 9 10 10 11 7 6 74 75 70 63 59 56 60 60 58 66 69 69 62 56 55 49 50 43 37 32 27 23 21 15 6 0 3 14 23 25 30 43 48 47 55 60 68 67 68 73 80 79 84 88 88 80 81 81 79 75 77
 13 16 21 25 33 37 37 30 30 30 27 26 30 21 20 17 16 20 24 30 31 38 45 48 37 36 36 35 31 28 27 18 14 16 4 7 12 12 13 15 13 14 10 10 9 9 6 12 12 70 63 62 61 65 64 59 65 72 76 79 81 68 65 61 59 54 53 43 35 29 32 28 23 18 4 21 24 29 40 41 45 54 55 59 69 67 74 84 85 87 93 95 91 82 78 70 74 77 73 75
 11 13 22 28 32 31 28 28 28 25 27 24 21 18 16 14 12 18 27 27 34 40 41 50 35 37 32 31 28 28 20 15 16 9 1 4 10 11 15 16 15 15 11 12 10 12 13 16 17 65 62 59 66 71 69 64 65 74 82 87 89 73 67 64 60 56 55 41 34 30 36 29 24 17 17 28 31 41 44 43 54 56 59 70 72 73 85 87 88 91 94 92 84 79 74 68 72 76 73 71
 11 15 25 32 30 31 27 22 27 25 25 19 23 22 17 19 17 23 31 28 33 43 43 47 37 38 40 34 26 24 24 18 22 12 4 6 7 15 19 16 14 13 13 13 9 14 19 20 16 59 60 57 64 69 66 67 67 78 85 90 95 80 73 69 63 60 56 44 40 33 37 32 26 22 16 28 33 45 43 44 53 57 63 76 76 76 87 91 85 91 90 92 83 76 72 68 68 70 67 69
 10 13 13 25 23 22 21 19 21 20 19 22 22 21 19 19 24 22 31 35 35 41 46 48 37 39 39 32 25 21 29 19 15 12 13 10 12 11 13 15 14 14 13 14 21 18 22 25 23 59 62 61 64 64 67 68 80 83 90 98 106 86 79 75 63 66 61 50 43 42 42 35 34 27 21 34 40 45 49 46 59 67 66 79 85 90 93 89 88 90 86 84 80 73 66 66 65 61 62 63
 7 9 13 18 19 17 15 16 15 15 19 21 17 18 20 24 25 27 34 39 37 43 44 51 37 39 36 28 24 21 16 14 12 12 16 10 9 9 13 12 14 12 16 15 15 19 21 25 27 61 64 64 65 65 68 76 82 86 93 96 101 92 83 77 75 76 68 51 46 46 43 42 36 28 29 33 37 49 53 54 67 67 72 83 87 92 94 91 90 88 82 81 76 75 70 65 63 58 58 59
 6 7 9 11 13 15 11 12 10 14 17 20 16 16 14 25 24 24 35 42 41 44 48 53 34 35 30 29 21 22 13 12 12 7 8 5 7 5 6 14 11 11 19 15 15 20 26 26 26 59 59 68 67 68 71 79 82 84 93 97 105 98 90 88 77 75 72 59 52 50 46 42 39 30 31 35 41 51 50 55 65 69 72 85 91 93 96 96 90 89 80 79 76 74 70 67 66 57 58 53
 1 5 6 4 4 2 1 3 9 12 12 11 15 17 12 16 16 21 23 31 36 37 49 49 34 32 32 30 26 24 19 13 11 11 8 3 1 1 5 11 14 21 21 26 25 28 27 26 26 59 61 66 70 73 80 83 89 95 99 102 105 103 91 87 85 76 68 65 61 58 55 52 51 41 30 45 46 51 61 64 67 74 80 84 92 95 99 88 81 80 73 74 73 65 66 67 68 69 58 53
 4 8 6 1 2 2 1 2 6 11 9 11 11 13 12 13 13 17 23 28 35 40 48 52 35 34 33 34 29 25 15 10 7 7 8 4 1 -4 0 10 14 17 23 26 27 26 26 26 24 51 51 57 64 69 74 76 80 87 92 96 102 90 87 86 79 77 72 65 65 60 60 60 55 46 42 50 51 58 64 68 72 74 76 82 90 93 93 85 81 75 69 71 67 64 67 68 71 73 63 55
 5 3 1 -1 1 1 -1 2 8 11 12 10 7 7 10 10 12 16 23 30 30 44 50 56 40 39 34 37 33 29 15 13 7 5 5 5 5 5 2 11 13 12 21 22 25 24 22 25 25 45 48 48 59 64 68 67 73 75 90 92 100 90 84 83 74 75 70 71 71 66 65 59 54 44 47 47 52 59 63 66 67 68 77 80 83 83 89 84 76 69 69 69 73 69 70 68 67 66 59 56
 0 -7 -7 -2 -1 0 0 5 6 10 15 10 7 7 7 11 13 12 22 30 36 43 48 56 43 45 43 40 36 32 22 16 14 7 9 8 8 9 11 9 12 10 17 16 21 20 20 18 16 43 40 42 51 56 60 62 63 71 84 91 97 88 80 80 76 75 71 73 71 64 63 59 57 54 45 48 49 58 68 72 68 69 69 72 70 73 85 73 70 69 69 73 72 69 71 71 69 67 62 62
 -10 -14 -10 -6 -4 -4 0 1 7 12 15 11 3 4 4 10 9 10 26 34 34 43 46 54 46 45 43 41 39 36 24 21 16 11 9 10 14 14 13 14 13 8 8 11 14 16 18 18 20 34 35 38 44 49 49 53 57 64 85 87 94 81 77 79 79 78 79 75 73 71 62 59 58 56 53 53 55 67 69 73 70 67 67 68 66 71 75 69 70 71 68 67 68 69 72 72 74 70 68 66
 -10 -10 -8 -8 -6 -5 -6 0 2 9 11 11 1 5 3 8 6 10 22 29 30 44 46 47 47 47 47 45 42 35 33 25 19 15 12 12 17 18 17 9 11 8 2 8 11 13 13 16 18 25 32 30 37 41 45 54 54 62 79 83 91 81 77 75 84 80 81 79 72 65 61 58 58 58 56 60 60 72 71 76 71 66 67 67 66 68 76 73 74 68 68 65 69 73 67 73 74 72 69 71
 -14 -13 -9 -7 -7 -4 -3 0 -1 2 5 6 3 -1 0 0 -2 4 16 26 27 31 43 49 51 47 47 42 37 34 31 29 25 24 23 24 23 20 21 15 8 7 1 12 8 11 16 13 20 26 24 25 25 29 32 43 47 53 60 72 81 81 76 79 79 78 82 74 70 70 64 69 70 64 64 64 66 70 73 76 70 69 66 65 65 62 81 77 72 73 69 68 70 72 71 72 70 66 67 74
 -16 -17 -11 -8 -9 -10 -8 -6 -3 0 3 6 -1 -3 -2 -3 -5 1 23 26 29 36 42 47 46 47 44 37 38 35 32 28 28 28 31 28 24 23 19 12 10 4 9 14 13 12 11 11 12 20 19 20 24 26 31 40 41 46 58 68 75 70 74 75 75 75 77 72 71 66 63 70 74 68 62 63 66 70 69 71 69 67 67 67 63 65 77 78 74 70 68 68 69 70 71 67 67 65 71 74
 -13 -15 -12 -9 -11 -13 -4 -9 -1 -3 0 0 -6 -4 -5 -2 0 5 22 23 26 34 44 48 42 40 36 35 35 33 37 30 28 20 27 28 25 22 24 17 11 11 6 10 13 12 10 8 13 18 17 22 22 29 29 33 37 40 52 61 68 70 71 73 73 74 73 71 69 65 62 68 72 69 62 62 67 66 72 69 72 70 68 66 59 60 76 76 66 69 69 70 71 70 71 66 64 66 71 71
 -14 -14 -12 -13 -14 -15 -10 -10 -11 -9 -8 -5 -8 -9 -9 -2 -1 2 23 24 26 39 44 50 36 33 33 34 34 34 31 28 26 27 28 30 23 22 23 15 11 11 10 11 9 14 13 12 12 16 17 15 25 28 30 31 32 33 50 55 64 62 67 69 73 73 73 67 65 67 62 63 65 68 62 66 69 71 71 72 71 71 68 64 61 61 72 73 71 72 72 73 68 67 64 62 64 66 66 70
 -13 -14 -11 -14 -15 -13 -12 -12 -12 -9 -12 -6 -4 -8 -6 -2 3 6 17 20 20 37 43 45 35 32 33 42 40 39 36 34 23 31 28 33 24 22 19 16 10 8 12 14 17 14 13 5 7 14 18 17 24 27 30 33 30 31 46 54 58 59 58 61 70 68 72 67 66 61 64 68 69 71 64 66 71 71 71 69 70 69 63 66 63 58 70 72 73 73 72 77 68 70 67 64 66 61 66 72
 -15 -13 -14 -15 -15 -17 -13 -13 -14 -13 -13 -8 -8 -8 -8 3 4 9 17 18 21 38 41 42 34 34 35 42 42 40 36 37 33 32 34 35 25 22 23 13 8 7 15 15 10 12 9 2 5 16 17 17 23 26 30 28 29 33 45 48 54 51 52 54 61 64 68 65 65 65 65 72 77 75 66 67 68 70 70 67 69 69 68 63 62 58 67 69 70 75 76 75 68 69 68 67 64 63 67 72
 -22 -19 -20 -17 -17 -17 -15 -14 -17 -13 -13 -9 -4 -6 -9 -2 1 8 14 21 22 33 39 44 33 37 38 40 43 43 42 39 36 37 37 36 35 28 27 21 12 13 16 12 5 7 3 0 3 6 10 15 13 21 27 27 28 29 42 43 47 49 50 50 56 58 60 70 68 70 71 72 77 68 67 70 64 70 69 68 68 68 67 57 58 58 60 64 67 70 68 67 69 69 69 70 72 72 69 72
 -26 -23 -19 -16 -6 -3 -2 -1 -4 -7 -6 -2 -6 -6 -7 -10 -9 -5 -8 -8 -2 0 -4 0 2 -1 -4 -1 -4 -4 -2 3 8 7 4 12 8 10 12 8 8 5 4 0 4 3 3 2 1 3 8 6 9 10 12 12 13 8 8 6 5 0 1 0 2 3 2 1 10 7 10 5 5 3 6 8 10 11 14 11 15 24 32 31 38 40 42 46 49 52 62 62 60 62 62 68 64 71 69 73
 -25 -25 -17 -8 -2 0 4 1 -3 -4 -4 -5 -2 -1 -4 -6 -6 -7 -7 -9 -4 -4 -8 -2 -2 -3 -3 -4 -4 -2 0 2 1 0 1 5 10 11 10 9 9 5 -1 0 0 4 5 3 2 7 9 5 11 10 14 13 16 14 9 7 3 3 3 3 9 9 6 11 14 11 13 10 6 5 11 7 10 13 15 14 24 31 31 39 42 42 48 48 49 55 60 58 59 60 64 64 67 71 73 75
 -25 -24 -21 -7 -2 0 2 1 -5 -5 -7 -9 0 -1 -4 -1 -2 0 -3 -6 0 1 -3 -3 1 -3 -4 -4 -4 1 2 -1 -5 -4 0 6 5 8 7 4 10 6 2 1 7 5 2 2 7 12 9 7 9 9 17 13 15 11 14 7 2 8 7 7 14 9 11 14 14 11 13 11 11 13 12 11 10 13 17 14 28 31 33 41 43 41 52 52 52 57 57 57 58 59 61 68 72 73 71 75
 -24 -19 -17 -6 5 11 7 3 -2 -8 -7 -10 0 2 1 0 -4 -6 -2 2 1 1 2 1 -4 -5 -7 -2 1 1 2 0 -2 -2 4 8 4 8 8 7 6 2 2 3 5 3 4 10 4 11 13 13 13 14 13 15 15 19 13 13 7 9 11 12 14 17 17 15 15 18 16 12 10 16 14 13 13 14 18 26 27 32 34 42 44 48 57 57 58 53 52 47 57 60 60 66 73 77 77 78
 -22 -19 -17 0 8 12 12 8 2 -3 -4 -8 5 5 1 -4 -9 -3 5 4 1 2 1 -5 -4 -5 -4 -1 1 1 6 4 2 4 6 6 9 10 9 6 6 5 1 0 5 2 7 13 11 12 15 14 16 17 16 17 18 19 18 21 19 13 11 15 16 17 19 18 15 16 18 14 12 13 14 13 13 20 23 26 30 30 35 46 52 55 59 57 55 52 51 48 53 59 62 66 73 80 81 81
 -23 -19 -16 0 10 14 17 13 7 -1 -3 -9 5 5 2 -1 -1 0 9 7 4 7 0 -4 0 0 -3 2 2 3 9 7 6 9 8 9 6 8 12 8 7 -1 1 2 0 2 3 5 6 14 15 18 15 18 18 18 18 19 21 23 23 11 13 17 18 19 23 21 18 19 18 14 13 15 18 16 15 21 25 26 35 35 37 49 52 52 63 57 55 56 50 47 54 57 65 67 75 79 83 84
 -25 -14 -8 -5 7 15 20 8 7 4 1 -1 6 7 6 7 8 10 9 10 13 7 2 3 2 5 7 7 13 12 14 13 13 11 10 12 10 12 12 8 8 4 5 5 5 4 3 2 5 11 14 12 18 19 19 20 19 21 21 23 23 16 23 22 22 24 22 24 21 21 16 16 16 18 19 20 25 29 33 30 34 42 46 45 53 53 62 58 57 55 51 51 51 61 64 69 78 83 85 92
 -17 -14 -11 -1 6 13 8 2 3 5 5 0 9 10 8 11 11 10 11 12 9 6 3 0 1 5 7 13 17 15 16 17 14 13 14 17 13 16 14 14 13 9 3 0 2 4 4 2 4 17 15 16 23 20 18 25 23 23 24 23 23 23 26 22 20 27 25 21 17 15 14 17 15 17 16 17 22 30 33 33 34 40 43 49 50 51 58 59 56 57 55 51 59 64 66 71 78 84 87 92
 -20 -12 -12 -3 4 12 5 3 5 9 6 5 14 10 10 11 13 8 12 11 11 9 4 0 3 6 7 9 15 17 22 18 13 16 13 15 12 16 18 15 13 10 4 1 1 0 3 4 5 21 19 21 24 22 17 26 23 25 21 21 21 22 23 24 20 23 28 20 14 11 13 16 12 16 20 21 25 31 33 34 32 38 42 47 53 48 57 59 59 57 53 55 61 66 69 74 81 83 89 91
 -16 -18 -13 -4 0 3 5 3 10 5 5 5 11 12 11 15 11 11 10 10 11 8 3 -1 5 5 1 11 17 21 21 18 17 14 20 19 15 14 17 16 10 10 2 2 0 3 2 0 3 26 30 31 30 25 23 26 27 25 22 23 23 17 14 12 17 19 20 17 14 10 10 15 16 15 22 22 27 32 29 31 33 38 43 48 48 50 58 56 58 56 51 52 62 71 76 77 75 83 88 93
 -18 -22 -18 -3 -2 1 2 2 4 2 2 6 16 16 18 14 13 10 10 8 9 6 2 0 4 4 4 9 14 15 21 21 21 20 24 20 14 12 16 13 11 10 3 3 4 5 3 1 3 32 30 32 28 25 23 27 26 23 20 22 22 15 13 14 17 20 20 18 16 14 10 12 15 19 17 19 24 27 28 27 36 40 41 46 44 46 57 59 59 54 51 57 65 70 74 75 80 83 86 92
 -15 -16 -12 -5 -1 -6 1 0 4 5 8 11 19 18 25 14 13 10 14 10 10 2 1 -1 4 2 1 5 12 15 22 21 12 22 24 22 18 16 15 14 11 11 11 7 5 6 3 8 9 37 35 30 32 28 29 26 25 24 24 22 20 12 14 13 17 20 21 18 19 18 15 12 18 21 19 21 27 27 26 21 32 36 41 47 47 48 56 59 59 58 54 60 64 68 74 75 78 83 88 90
 -8 -1 -3 -3 2 11 14 14 7 12 15 18 18 13 9 13 10 8 8 2 0 0 -6 -8 -2 -1 0 2 8 9 8 9 11 13 14 14 19 13 13 16 19 18 17 14 17 16 17 11 13 41 35 35 26 23 20 23 17 15 19 14 18 15 14 16 13 13 15 16 24 28 30 30 31 28 17 20 26 27 34 35 37 38 39 42 48 51 57 57 63 57 56 58 59 70 74 77 81 84 87 87
 0 0 -2 -1 0 5 9 9 7 8 12 15 13 14 15 11 10 7 6 3 2 -4 -10 -11 -3 -1 1 6 10 8 0 5 8 10 8 13 7 5 11 14 15 13 12 15 14 18 13 10 12 36 36 29 20 22 23 14 14 12 12 10 11 15 18 16 17 16 18 25 27 29 32 32 33 30 22 20 25 33 35 39 35 37 39 47 51 53 59 60 60 59 59 59 66 71 78 77 80 86 85 85
 0 -2 -1 4 0 1 9 8 8 5 11 13 11 14 11 10 10 5 6 2 6 -5 -5 -15 -2 -4 -2 -2 4 6 -3 2 4 13 10 10 8 5 6 10 11 13 15 15 14 18 9 9 17 34 28 25 18 19 20 15 14 14 17 13 13 16 17 21 19 20 20 30 31 30 33 31 34 31 28 26 29 35 36 38 38 39 36 49 51 49 60 59 60 58 58 63 69 72 83 79 80 85 83 85
 -3 0 2 1 4 7 6 6 6 9 13 16 10 7 6 11 11 8 6 2 2 -3 -6 -6 -6 -3 0 -1 0 0 -6 -3 -1 9 11 10 4 7 3 7 8 8 10 11 11 14 12 16 9 27 23 18 17 14 17 18 16 15 13 10 12 17 20 21 22 32 32 34 37 36 36 37 36 35 27 33 38 35 41 37 36 43 47 45 47 50 56 52 56 60 63 63 68 74 74 81 79 76 79 85
 -4 -4 -1 3 2 3 5 5 7 13 13 18 4 4 8 10 13 10 3 1 0 -6 -5 -9 -6 -4 -4 -1 -1 -5 -12 -8 -5 9 13 10 2 7 5 4 5 6 7 6 11 11 12 15 15 22 20 19 13 10 13 13 14 14 8 5 8 20 23 27 38 43 40 40 38 36 38 36 36 34 29 32 36 40 42 41 44 45 45 47 46 47 50 48 52 60 61 64 71 73 78 80 77 77 81 85
 0 -1 -3 5 3 6 9 6 5 14 11 9 2 3 3 8 6 4 3 1 -2 -10 -9 -9 -5 -5 -10 -7 -7 -9 -14 -11 -3 3 6 6 -3 -2 0 5 2 -1 7 5 5 7 9 14 20 18 15 14 9 12 14 9 11 9 6 4 6 17 24 27 43 44 41 43 41 39 42 36 37 37 34 35 37 37 41 40 44 44 51 49 48 52 48 52 59 60 61 60 69 71 74 78 78 78 82 84
 3 1 0 1 -1 0 5 3 6 8 12 15 2 3 3 3 5 2 3 -5 -9 -10 -14 -18 -9 -14 -12 -11 -12 -13 -17 -7 -6 -6 1 0 -3 2 -2 3 6 2 2 1 6 5 12 16 16 13 10 11 14 12 13 8 6 4 4 5 9 21 30 35 36 41 44 46 43 46 43 42 40 39 35 35 38 39 37 39 42 45 47 51 54 53 55 52 53 54 62 62 68 73 72 76 81 78 76 83
 0 0 1 0 -3 -3 2 2 4 9 11 16 2 8 6 10 9 5 -4 -10 -15 -16 -15 -14 -18 -20 -16 -12 -10 -16 -13 -4 -4 -4 0 0 -1 3 6 9 14 10 0 0 2 5 13 17 20 12 8 11 12 7 6 8 7 5 8 10 10 29 33 35 38 38 42 45 44 44 40 40 38 37 35 32 34 36 33 35 42 42 47 54 58 55 49 47 47 54 61 63 69 73 75 75 77 77 80 81
 0 1 7 0 -2 0 0 0 0 8 9 13 2 7 8 4 7 1 -3 -14 -17 -17 -15 -14 -22 -21 -15 -13 -14 -17 -13 -5 -9 -8 -2 -4 -6 4 6 10 10 7 -1 0 0 8 14 18 25 13 9 13 14 7 4 4 7 7 9 10 11 28 32 31 39 41 45 42 44 45 41 38 37 34 36 34 33 32 34 35 41 43 48 50 54 55 45 47 43 50 58 56 72 70 74 75 70 75 74 77
 3 5 6 0 -3 -7 0 2 2 8 11 12 4 7 8 5 4 3 -10 -13 -17 -17 -17 -18 -23 -19 -17 -16 -17 -17 -14 -11 -10 -8 -8 -4 5 8 10 7 7 5 2 5 7 9 13 23 28 10 9 12 6 4 1 8 11 12 10 11 12 33 34 34 41 43 43 42 42 43 42 38 34 32 33 32 30 32 31 33 45 51 51 53 54 57 45 44 42 53 57 59 70 73 74 76 79 78 75 75
 0 1 2 -4 -8 -11 -3 0 2 10 6 10 4 2 6 5 1 3 -8 -8 -19 -14 -18 -20 -28 -25 -20 -15 -11 -16 -17 -17 -11 -10 -11 -9 0 -1 1 8 6 8 6 10 12 13 17 19 25 15 9 7 4 2 3 8 11 14 12 14 20 31 35 35 36 38 37 40 40 43 39 38 37 35 39 32 32 31 31 34 44 48 47 50 49 51 44 46 47 51 58 56 71 71 73 69 69 69 76 73
 -4 -3 -3 -10 -11 -12 -2 -3 0 3 3 4 2 0 2 0 0 0 -4 -4 -10 -20 -20 -22 -29 -27 -26 -11 -7 -16 -21 -21 -16 -14 -13 -13 -8 -7 -1 4 4 5 12 17 16 17 14 13 22 13 11 10 4 1 4 8 10 16 17 17 20 34 36 33 32 32 34 36 36 37 39 39 40 35 31 30 33 31 31 30 42 43 43 46 46 46 47 47 46 54 55 54 70 73 67 62 61 58 62 67
 -5 -6 -10 -13 -15 -8 -6 -5 -2 3 3 3 2 3 5 0 0 2 -1 -4 -11 -16 -21 -23 -29 -31 -26 -18 -17 -13 -24 -23 -21 -15 -15 -12 -11 -5 -1 1 5 8 11 16 16 20 18 22 31 15 9 10 3 3 6 10 7 15 14 18 19 29 33 34 29 32 28 38 36 39 37 36 37 34 29 32 30 31 32 31 35 39 42 42 43 43 46 47 49 57 54 52 60 63 55 56 57 56 58 61
 -9 -13 -14 -18 -21 -26 -23 -15 -9 -4 0 0 5 5 -1 -3 -11 -12 -13 -15 -19 -19 -23 -29 -31 -26 -30 -27 -22 -15 -18 -12 -10 -8 -6 -9 -7 0 4 11 16 14 22 29 32 33 38 35 33 12 13 13 14 16 19 20 21 25 23 32 28 35 38 36 37 37 36 37 40 36 34 36 40 37 33 34 34 36 42 44 46 51 58 62 68 70 69 62 61 63 52 51 52 49 54 54 55 58 54 54
 -12 -14 -16 -22 -23 -23 -20 -17 -9 -4 -4 0 7 5 0 -6 -10 -9 -9 -12 -13 -19 -22 -27 -30 -29 -28 -26 -22 -19 -12 -9 -10 -8 -10 -9 0 0 4 15 17 22 24 27 30 33 34 35 37 7 12 13 11 14 16 16 20 20 24 31 32 36 37 36 37 35 36 42 45 37 33 38 41 37 30 29 32 40 44 45 44 47 54 66 69 67 61 56 57 47 48 49 49 49 52 51 54 58 56 54
 -13 -14 -16 -25 -24 -26 -24 -15 -5 -6 -4 1 9 7 4 0 -2 -2 -6 -8 -8 -18 -22 -25 -29 -33 -33 -26 -22 -20 -12 -16 -9 -11 -6 -4 6 3 10 17 17 24 15 28 33 33 32 36 39 4 9 7 6 12 12 12 15 19 23 25 31 39 36 36 36 37 36 45 41 37 33 33 35 34 37 35 39 37 43 46 44 48 49 62 65 64 57 53 52 45 49 50 44 50 52 52 52 54 54 51
 -16 -16 -19 -24 -28 -24 -18 -12 -9 -7 -1 4 10 6 6 1 0 0 -5 -7 -13 -16 -28 -32 -32 -31 -33 -28 -22 -17 -15 -9 -11 -5 -3 3 6 10 15 14 19 18 21 24 27 31 33 31 34 2 3 3 4 6 10 11 13 15 19 25 30 35 38 38 36 35 34 43 39 37 31 32 36 31 36 40 41 42 40 40 44 47 50 56 54 59 51 42 41 45 46 53 50 53 49 54 52 56 55 53
 -15 -17 -17 -22 -25 -26 -15 -11 -14 -5 -3 -1 9 6 3 2 0 1 -5 -8 -11 -27 -31 -33 -32 -29 -28 -24 -21 -17 -12 -9 -10 -2 -1 -1 10 10 9 15 18 17 19 20 25 28 30 29 33 0 1 1 0 3 3 7 11 12 17 19 25 37 39 40 39 37 41 41 38 36 29 32 38 34 43 41 41 40 40 42 43 43 49 52 50 53 42 39 39 43 47 51 52 52 54 58 56 57 57 56
 -14 -14 -15 -20 -24 -28 -21 -16 -14 -7 -2 -3 10 7 5 0 -1 0 -5 -11 -14 -28 -31 -36 -28 -27 -28 -19 -21 -19 -17 -10 -8 -7 1 4 13 12 11 16 19 17 20 16 18 24 29 28 33 0 2 0 -2 -1 -1 3 6 4 12 16 24 39 38 42 38 42 39 40 37 36 32 35 35 30 41 43 43 41 41 40 40 44 44 47 50 52 40 37 39 45 45 47 52 54 56 61 57 58 55 58
 -9 -17 -19 -22 -26 -25 -24 -20 -17 -8 0 -2 6 2 4 6 1 -4 -7 -14 -19 -20 -27 -37 -27 -26 -24 -20 -16 -14 -15 -8 -1 0 4 5 13 9 8 11 14 17 18 21 22 21 25 28 29 -2 -3 -2 -1 -3 -5 -3 3 7 10 17 19 36 40 39 39 43 46 43 39 32 33 31 28 32 45 44 41 41 36 37 40 41 43 38 45 48 37 40 42 44 47 49 52 46 48 47 49 48 51 55
 -15 -23 -25 -26 -26 -25 -20 -16 -11 -4 -1 2 1 -2 -1 3 1 -5 -17 -20 -20 -23 -26 -32 -31 -32 -29 -18 -15 -15 -13 -12 -6 3 5 7 13 7 9 13 15 17 20 19 19 20 24 26 31 -6 -6 -2 -3 -5 -7 1 2 4 12 15 18 39 41 39 43 42 42 40 37 35 32 29 27 28 43 43 42 36 32 35 40 39 37 40 42 45 36 37 39 41 45 47 42 40 46 45 47 48 49 49
 -16 -21 -24 -26 -25 -20 -17 -15 -4 1 0 -4 0 -2 2 0 0 -5 -16 -18 -20 -22 -28 -29 -30 -31 -31 -24 -21 -22 -9 -9 -3 4 6 10 15 12 11 17 17 18 21 17 17 20 24 24 33 -6 -6 -3 -5 -8 -6 3 2 5 13 18 17 37 39 41 42 38 40 38 34 30 30 27 28 27 44 44 41 31 32 33 39 42 39 37 40 41 34 34 37 37 42 41 42 44 46 44 46 44 50 47
 -17 -25 -23 -25 -20 -23 -17 -11 -2 2 0 -2 2 0 3 -2 -12 -13 -19 -20 -18 -26 -31 -34 -28 -26 -26 -26 -21 -21 -11 -1 0 9 12 12 15 16 16 17 22 26 21 17 15 18 25 30 35 -8 -7 -5 -7 -4 -4 1 4 5 13 18 20 36 38 41 39 39 37 38 32 27 30 30 33 32 46 41 33 36 33 34 38 35 36 39 45 40 31 32 28 38 41 43 40 41 45 43 42 42 44 44
 -25 -26 -26 -20 -19 -18 -16 -13 -6 -5 -6 -5 0 -3 -3 -10 -12 -16 -23 -27 -23 -29 -29 -32 -30 -25 -27 -23 -19 -19 -6 -3 0 10 12 16 21 21 20 21 26 28 20 19 20 21 25 30 32 -9 -8 -9 -6 -4 -5 3 6 9 19 22 21 34 38 37 35 37 38 34 31 31 31 30 33 32 46 42 39 36 33 32 33 33 33 41 45 44 29 29 29 35 37 39 39 40 40 42 43 42 44 44
 -26 -26 -25 -15 -15 -14 -12 -13 -9 -6 -4 2 -3 0 -1 -15 -14 -18 -25 -27 -21 -28 -27 -34 -30 -26 -29 -22 -16 -19 -4 -7 0 11 12 20 22 23 15 21 25 22 17 21 21 25 27 30 29 -10 -10 -12 -11 -7 -4 -4 4 4 16 21 22 36 35 35 35 36 34 36 33 34 32 35 34 34 49 45 45 39 34 33 32 29 33 36 40 41 30 27 30 32 32 36 36 36 43 42 40 42 44 47
 -31 -26 -22 -20 -18 -15 -12 -8 -6 -1 -2 2 0 1 -2 -1 -7 -10 -7 -11 -14 -14 -21 -24 -34 -25 -26 -19 -9 -8 -3 8 12 13 16 16 21 24 27 24 27 27 25 27 28 27 28 27 31 -14 -7 -5 2 6 6 7 14 14 17 24 26 31 32 34 33 41 43 40 46 43 44 41 38 36 51 54 53 56 56 56 56 52 45 44 38 37 30 26 33 29 30 31 32 35 41 44 40 36 39 42
 -27 -28 -23 -20 -19 -15 -13 -9 -6 -3 -2 1 1 2 -1 -7 -8 -8 -12 -17 -17 -19 -20 -25 -24 -21 -17 -8 -6 -3 5 10 13 13 13 18 23 28 26 22 26 23 25 27 29 26 25 25 29 -13 -10 -2 6 8 6 9 14 17 19 24 25 32 35 32 37 41 42 48 52 48 46 43 39 42 54 53 56 56 58 55 48 49 44 37 33 28 27 22 25 26 28 31 33 32 40 40 36 32 36 38
 -23 -24 -21 -17 -16 -16 -8 -10 -9 1 1 6 2 0 -1 -5 -7 -9 -14 -15 -16 -17 -18 -21 -21 -22 -14 -9 -5 0 9 14 14 19 16 14 17 24 26 20 22 25 20 25 25 25 22 24 23 -16 -11 -3 7 6 6 6 9 11 15 23 25 31 34 34 44 43 45 50 46 48 45 45 45 43 48 51 53 52 55 54 47 44 40 35 33 31 30 22 24 31 29 31 30 35 39 39 36 34 33 36
 -21 -23 -18 -17 -16 -16 -14 -6 -6 0 6 9 1 0 -1 -6 -8 -10 -11 -16 -16 -19 -20 -19 -20 -10 -11 -5 4 10 7 11 18 19 14 10 14 13 17 19 12 16 20 18 20 20 19 18 19 -15 -5 1 3 6 3 3 11 11 16 13 18 32 35 38 40 44 47 49 47 49 48 48 45 46 50 51 53 52 49 46 44 43 46 35 30 29 26 25 23 29 28 30 32 36 31 35 33 31 32 32
 -23 -25 -20 -13 -12 -14 -8 -4 -1 4 4 11 -1 0 -3 -7 -5 -7 -14 -18 -19 -16 -17 -15 -10 -8 -5 2 10 9 9 9 12 13 12 12 7 10 12 6 4 9 12 16 16 16 16 17 21 -10 -5 -4 4 9 5 13 15 17 12 10 17 31 35 36 42 46 49 50 49 46 51 47 43 45 47 46 50 50 49 45 41 44 40 28 28 25 25 24 23 27 28 26 30 34 33 32 30 30 30 30
 -24 -18 -21 -16 -13 -17 -7 -2 1 8 7 16 0 -3 -1 -5 -7 -7 -14 -16 -11 -15 -11 -9 -9 -7 -3 3 9 9 7 7 11 12 12 11 2 4 5 3 3 4 8 11 13 12 12 12 18 -10 -8 -2 7 9 9 12 15 12 16 15 17 29 33 35 41 45 50 55 50 51 51 51 49 49 45 50 52 48 45 42 35 34 28 27 25 25 24 26 23 23 28 24 28 29 30 27 21 26 25 27
 -19 -16 -20 -16 -12 -13 -6 -4 -3 0 9 15 -2 -4 -3 -3 -7 -13 -11 -11 -13 -13 -9 -6 -8 -7 -3 2 9 11 8 9 9 11 8 6 -1 4 0 6 5 1 3 9 11 12 9 15 12 -11 -3 2 2 10 11 13 14 18 19 23 21 28 30 32 39 46 49 54 48 49 40 43 46 50 52 43 42 41 40 33 30 28 24 26 21 18 24 31 29 29 25 22 25 21 20 16 21 19 18 21
 -15 -13 -14 -10 -9 -10 -5 -6 -5 -2 5 15 -3 -7 -5 -5 -7 -7 -2 -4 -6 -12 -11 -8 -5 -10 0 5 7 5 5 7 11 10 9 9 4 5 8 6 5 0 6 9 11 12 14 15 16 -4 0 2 8 9 11 11 12 16 21 23 26 26 28 31 40 45 49 48 46 44 35 40 47 49 44 39 37 42 41 37 27 28 31 29 21 22 30 33 33 28 26 25 21 22 22 13 16 19 19 19
 -15 -11 -10 -9 -10 -6 -7 -8 -5 -6 4 10 -2 -6 -6 -5 -3 3 0 -4 -4 -4 -5 -7 -7 -4 -2 3 2 6 5 11 10 7 12 13 4 6 8 6 2 2 3 7 12 10 12 12 13 -4 2 4 5 11 10 15 14 16 22 25 28 25 27 26 39 44 49 47 45 40 35 39 47 51 39 44 44 45 40 39 26 32 34 36 28 26 32 33 31 26 22 25 12 18 17 14 16 20 15 18
 -6 -5 -6 -8 -7 -4 -6 -9 -10 0 6 11 -2 -4 -6 -1 2 6 4 3 0 1 3 1 0 0 3 0 -2 1 7 9 15 13 15 11 5 5 8 2 -1 -3 4 6 5 8 7 9 8 0 3 6 13 15 15 13 16 17 23 24 26 26 29 31 42 48 50 43 41 39 35 37 39 44 44 45 45 39 37 35 35 37 38 36 34 31 31 32 31 26 24 23 14 14 14 15 16 13 14 17
 -9 -7 -5 -8 -5 -7 -2 -5 -9 4 6 10 -1 1 0 3 4 5 4 10 0 1 2 -1 -2 -1 0 3 -1 0 3 5 7 11 12 6 9 7 9 1 3 -6 1 5 4 2 5 3 8 -1 0 5 11 13 16 15 8 20 20 19 22 25 25 31 39 45 51 40 45 42 36 34 35 45 40 40 45 40 39 40 38 44 42 35 31 30 27 34 30 26 24 21 8 9 14 12 13 11 15 13
 -5 -5 -6 -8 -5 -4 -3 -2 -3 3 5 9 4 3 3 9 8 11 15 16 9 0 0 2 0 1 2 0 -1 -1 -2 -3 2 9 11 9 8 7 7 5 5 -2 0 0 2 0 -1 -3 2 -2 -2 1 13 14 15 7 5 14 19 18 20 26 27 30 40 44 45 48 47 45 35 32 32 40 37 33 38 41 43 40 46 50 46 29 28 32 32 32 29 21 20 20 6 5 5 10 8 8 7 10
 0 -6 -5 -7 -4 -3 0 1 -2 3 4 7 8 8 13 16 17 17 15 15 9 5 6 5 7 2 0 -5 -2 -6 -4 -3 -1 4 7 7 9 7 7 2 4 2 -1 -3 -4 -5 -4 -2 0 4 2 6 13 15 15 11 14 15 17 18 18 27 28 30 37 39 45 44 46 46 40 37 38 40 38 34 40 35 41 40 42 41 36 33 32 35 32 31 30 19 17 13 3 4 8 5 4 4 6 6
 -2 -4 -7 -5 -3 0 2 1 3 4 5 8 12 13 16 22 24 23 17 13 12 10 8 6 3 3 1 -3 -4 -5 -3 -3 0 1 4 5 6 8 8 4 4 -1 -6 -6 -6 -5 -1 -1 1 6 8 9 14 16 16 18 18 20 19 20 23 26 28 29 29 32 38 40 41 42 43 40 42 43 42 41 42 41 39 38 33 32 32 34 34 34 33 30 28 17 13 8 2 1 0 -1 -1 -1 0 0
