 0 0 -1 0 -5 -4 -3 0 -2 0 0 -1 0 0 0 -1 0 0 3 -1
 1 -2 -3 0 -6 -3 2 2 2 -1 1 0 6 5 7 8 9 4 1 -2
 3 1 -2 -2 -9 0 10 4 5 -1 0 1 9 13 15 14 16 7 2 -3
 3 1 -2 -4 -10 -1 4 2 1 0 2 8 17 23 21 17 16 6 3 -2
 3 0 -5 -6 -10 -1 0 2 5 -1 8 16 20 23 27 20 15 7 3 -1
 -2 -6 -3 -8 -7 -1 0 3 1 4 8 13 16 17 24 16 13 5 3 0
 -8 -6 -4 -4 -3 0 4 5 9 5 6 9 10 12 17 13 8 2 -3 0
 -9 -5 -5 -3 1 3 7 9 6 4 4 4 6 8 11 11 3 2 1 0
 -11 -2 -3 -1 -4 5 4 8 7 2 3 3 5 4 5 8 5 3 7 0
 -10 -2 4 8 12 10 10 6 4 1 2 4 0 0 1 0 0 0 2 1
 -3 2 6 5 8 9 5 2 4 0 0 -1 -5 -4 0 -2 -1 -2 2 0
 0 2 7 7 4 3 0 3 1 0 -5 -9 -7 -5 0 0 -3 -5 0 0
 2 4 2 1 1 2 4 3 0 -2 -6 -8 -10 -9 -5 -7 -8 -8 -2 0
 4 5 0 1 0 0 4 3 2 -4 -9 -5 -8 -10 -8 -7 -7 -7 -5 -1
 4 3 2 0 0 0 -1 0 -4 -2 -6 -7 -8 -9 -8 -7 -7 -7 -6 -4
 1 6 4 0 0 2 1 2 -3 0 -3 -9 -10 -9 -5 -5 -6 -2 -1 -2
 -1 0 5 1 -1 2 5 1 -2 5 -2 -10 -4 -5 -1 -2 -4 -2 0 1
 0 1 0 -5 -1 2 4 2 1 4 0 0 1 0 -4 -3 -1 0 3 3
 2 0 -3 -6 -4 1 2 0 0 2 0 1 1 -1 -1 -3 0 0 2 2
 0 -3 -3 -4 -2 0 2 3 5 3 3 4 2 1 0 0 -1 -2 -1 0
