 0 -1 2 5 9 4 6 7 9 13 17 19 24 17 18 18 16 12 17 14 15 14 14 11 13 3 1 1 -3 -5 -9 -15 -16 -25 -30 -34 -33 -37 -43 -43 -47 -58 -58 -61 -64 -64 -67 -69 -71 -77 -76 -76 -80 -76 -78 -78 -71 -70 -68 -62 -60 -54 -48 -45 -44 -38 -35 -35 -34 -34 -32 -34 -36 -36 -39 -30 -30 -26 -22 -26 -26 -17 -21 -16 -13 -15 -20 -12 -9 -10 -7 -7 -6 -3 -2 0 -1 -4 -2 0
 -5 -5 0 6 8 5 6 4 5 11 15 18 18 17 18 20 17 18 18 17 18 14 11 13 3 0 0 -1 -5 -8 -10 -11 -19 -26 -29 -31 -36 -36 -39 -42 -44 -52 -57 -58 -59 -62 -64 -67 -71 -75 -72 -76 -73 -72 -76 -74 -72 -68 -62 -62 -59 -48 -47 -46 -38 -36 -35 -30 -32 -32 -30 -30 -35 -36 -27 -26 -23 -14 -14 -14 -12 -12 -12 -5 -7 -11 -8 -6 -5 -4 -2 -3 -6 -7 -4 -2 -4 -6 -4 -1
 -2 -3 2 2 4 2 3 3 8 9 13 17 18 19 21 21 19 20 17 20 18 18 14 10 6 0 0 0 -1 -7 -12 -12 -20 -27 -27 -27 -37 -37 -36 -41 -45 -52 -58 -57 -59 -61 -60 -67 -68 -81 -75 -77 -75 -75 -76 -71 -68 -65 -58 -58 -53 -46 -45 -41 -36 -34 -34 -32 -33 -29 -26 -29 -32 -32 -26 -24 -21 -13 -13 -13 -6 -6 -5 -1 -4 -6 -5 -5 -3 -5 -1 -1 -5 -6 -4 -5 -7 -6 -3 0
 -2 0 2 0 -1 -1 2 1 0 5 8 9 18 21 25 25 19 23 23 21 21 18 20 16 5 6 8 2 -2 -4 -11 -16 -17 -21 -21 -22 -35 -36 -39 -42 -44 -49 -55 -51 -53 -56 -56 -61 -63 -80 -74 -77 -72 -72 -72 -67 -62 -59 -55 -52 -52 -44 -38 -35 -35 -34 -27 -31 -29 -30 -23 -22 -26 -29 -25 -14 -12 -9 -5 -5 -2 6 9 2 4 3 -2 0 -2 1 -1 0 -3 -4 -5 -4 -1 1 -1 -1
 -2 0 0 -3 -5 -2 0 0 0 7 9 12 20 22 24 22 18 21 21 20 20 22 24 20 5 7 6 1 0 -2 -10 -13 -15 -18 -20 -23 -34 -35 -36 -41 -44 -47 -49 -47 -52 -54 -58 -60 -61 -73 -74 -72 -71 -72 -71 -62 -59 -58 -55 -54 -52 -41 -38 -36 -34 -35 -31 -25 -26 -25 -18 -22 -26 -24 -15 -11 -6 -3 -2 2 9 13 14 12 13 8 1 0 0 0 -1 1 -3 -3 -4 -3 0 3 -1 -3
 -3 -1 -1 -6 -4 -5 -2 0 2 3 5 6 18 20 20 21 22 28 24 23 23 25 22 17 9 7 5 1 2 -4 -7 -10 -14 -18 -20 -22 -33 -34 -36 -34 -39 -45 -46 -49 -51 -52 -51 -57 -61 -70 -72 -70 -68 -68 -67 -59 -60 -54 -54 -53 -49 -40 -38 -36 -33 -30 -30 -22 -22 -23 -17 -19 -20 -20 -14 -10 -3 2 3 7 9 14 15 13 15 13 6 3 2 3 -2 4 1 0 0 -2 0 0 -1 -2
 -6 -5 -5 -2 -3 -3 -2 -4 2 2 3 6 19 16 16 19 24 27 26 21 20 17 16 16 8 4 2 3 1 0 -7 -8 -12 -15 -18 -22 -32 -32 -38 -38 -42 -43 -48 -46 -45 -41 -43 -43 -50 -68 -65 -64 -62 -60 -60 -62 -55 -51 -53 -52 -48 -40 -34 -35 -34 -28 -28 -22 -20 -26 -21 -22 -20 -20 -11 -2 1 1 8 9 14 12 13 15 16 14 8 6 7 5 8 5 4 9 5 7 1 -2 -1 -4
 -1 -3 -2 1 0 0 -2 -3 -2 -1 1 5 18 15 18 22 24 25 24 21 21 19 16 15 9 5 4 4 2 -1 -10 -9 -12 -17 -16 -19 -29 -30 -34 -41 -45 -45 -43 -43 -41 -39 -39 -42 -44 -62 -61 -61 -55 -56 -59 -54 -54 -53 -52 -52 -47 -36 -32 -33 -28 -22 -21 -17 -18 -19 -16 -18 -19 -17 -6 0 2 8 9 8 9 11 14 15 18 16 11 8 8 12 12 8 6 7 6 5 2 -4 -3 -3
 2 0 2 2 0 0 -1 -3 1 -2 0 1 20 19 17 20 24 26 26 25 22 18 17 20 12 8 8 4 0 -6 -6 -10 -13 -15 -18 -17 -32 -31 -31 -38 -42 -40 -39 -39 -41 -36 -38 -41 -45 -61 -58 -49 -54 -55 -59 -52 -55 -52 -51 -49 -43 -40 -36 -35 -27 -22 -17 -13 -17 -18 -16 -15 -16 -13 -8 1 2 8 7 9 8 10 13 15 19 24 17 10 7 14 12 6 11 8 7 8 0 0 0 -5
 5 7 5 4 4 2 0 -2 -2 0 2 7 19 20 21 24 25 24 30 23 23 19 16 13 15 12 10 3 -1 -6 -8 -10 -12 -16 -14 -17 -30 -29 -33 -36 -38 -37 -39 -38 -36 -38 -40 -41 -44 -55 -48 -45 -49 -49 -50 -53 -47 -50 -47 -44 -47 -39 -35 -36 -25 -16 -16 -13 -11 -9 -12 -8 -9 -8 -3 4 5 9 5 8 7 10 8 16 18 22 18 19 17 15 15 9 9 5 6 7 3 2 0 -4
 11 9 7 2 3 0 2 -1 -2 4 3 2 14 17 17 23 26 26 25 23 21 16 15 15 15 14 10 3 1 0 -8 -10 -11 -11 -9 -13 -24 -28 -33 -37 -40 -37 -34 -37 -38 -39 -43 -42 -45 -49 -44 -44 -46 -46 -47 -46 -41 -43 -43 -43 -45 -36 -34 -30 -20 -17 -15 -9 -7 -6 -10 -10 -8 -7 1 4 8 5 5 4 6 8 10 13 16 23 22 20 20 18 19 13 3 0 1 7 4 1 -1 -5
 11 7 6 3 2 1 0 0 0 2 2 3 8 14 17 22 26 24 24 25 20 17 17 14 19 15 12 4 0 -1 -9 -9 -9 -11 -14 -12 -20 -27 -32 -36 -36 -32 -32 -37 -38 -41 -39 -42 -45 -45 -44 -43 -48 -42 -46 -42 -41 -43 -41 -41 -42 -34 -32 -26 -18 -14 -11 -4 -5 -7 -5 1 -3 -3 0 3 4 3 1 0 5 6 8 13 16 24 25 23 19 16 16 12 3 4 0 4 4 1 -2 -4
 11 7 2 3 3 6 2 0 1 1 3 1 6 8 10 12 9 9 7 11 8 12 15 18 22 21 16 13 8 7 2 -1 -3 -4 -6 -11 -20 -22 -24 -26 -24 -27 -31 -31 -35 -35 -36 -37 -41 -47 -46 -47 -48 -41 -43 -47 -38 -39 -41 -36 -38 -31 -24 -24 -18 -13 -12 -11 -8 -4 -3 0 -6 -4 1 9 10 13 13 13 12 18 21 22 25 33 27 28 27 26 24 19 18 10 7 5 4 0 -2 -5
 11 10 8 7 8 8 5 0 3 7 4 4 9 8 11 11 12 8 11 14 14 16 19 22 24 24 18 11 10 8 7 1 -1 -2 -4 -7 -16 -21 -21 -21 -21 -24 -30 -32 -33 -35 -36 -37 -41 -44 -45 -45 -39 -34 -39 -33 -30 -33 -32 -33 -33 -21 -22 -19 -12 -11 -9 -8 -6 -4 -1 -2 -7 -6 9 10 10 13 15 16 15 16 18 22 24 28 29 29 30 24 24 21 10 6 7 4 1 -1 -5 -6
 10 10 9 7 10 11 7 6 1 10 5 4 12 10 15 13 11 7 10 12 16 13 21 23 21 19 16 15 10 14 11 5 1 -1 -2 -6 -8 -15 -17 -18 -19 -29 -26 -28 -29 -35 -34 -35 -37 -41 -43 -47 -39 -36 -36 -25 -25 -28 -27 -30 -32 -15 -17 -11 -8 -8 -7 -5 -3 -2 0 -3 -1 -1 12 12 11 15 14 15 20 16 20 22 23 25 30 28 34 24 24 22 10 7 7 4 5 -2 -2 -7
 9 10 11 11 14 14 12 9 9 6 10 8 12 15 14 13 7 11 8 14 13 19 22 24 17 16 15 15 17 21 14 11 9 1 3 2 -5 -10 -11 -17 -20 -24 -26 -29 -30 -33 -36 -34 -36 -40 -37 -38 -35 -31 -30 -20 -20 -24 -23 -22 -25 -13 -11 -9 -8 -7 -8 -5 -1 2 2 2 2 0 14 17 14 15 10 16 20 18 20 19 19 24 28 25 26 26 17 13 8 4 3 5 0 -4 -7 -9
 13 13 12 15 17 16 16 12 12 13 14 11 17 16 15 10 6 8 13 19 18 21 22 25 18 15 17 20 21 21 20 16 11 9 9 6 -7 -12 -12 -18 -17 -18 -24 -27 -29 -34 -33 -35 -37 -36 -35 -33 -28 -28 -24 -16 -19 -17 -15 -16 -18 -10 -11 -11 -7 -6 -9 -1 -2 -1 3 4 2 6 17 17 18 11 8 12 17 16 15 20 19 22 22 24 24 16 13 10 0 0 2 4 -1 -5 -7 -9
 15 14 13 15 15 18 21 18 18 18 18 14 18 18 14 10 7 8 12 17 19 24 24 24 22 18 15 18 22 21 24 16 18 15 14 13 -2 -7 -10 -14 -15 -17 -24 -25 -28 -32 -33 -35 -40 -35 -36 -33 -25 -21 -17 -12 -13 -10 -8 -12 -18 -9 -9 -9 -7 -9 -10 -1 -1 0 0 -1 4 7 17 15 13 14 11 9 15 14 12 15 19 23 19 19 16 13 11 6 0 -1 1 1 0 -4 -9 -9
 15 19 17 18 25 28 24 24 22 21 18 16 17 12 12 14 10 6 13 20 21 23 27 28 23 26 25 28 30 30 25 21 18 16 16 16 0 -1 -3 -4 -9 -13 -20 -23 -32 -28 -28 -28 -31 -36 -27 -21 -18 -8 -4 -5 -4 -7 -7 -10 -5 -5 -2 0 -1 0 0 -1 7 7 14 17 14 11 17 21 19 16 15 14 14 14 18 18 17 16 16 13 15 10 4 2 0 -1 -2 -1 -3 -2 -9 -10
 20 22 19 26 28 27 25 26 25 20 17 15 13 8 10 12 10 10 18 24 25 26 26 28 26 30 30 31 33 33 27 24 19 18 17 16 1 0 -2 -6 -7 -13 -15 -18 -25 -24 -24 -24 -29 -26 -25 -19 -6 -3 -1 -3 -3 -3 -5 -8 -6 1 3 3 5 2 0 8 11 15 20 17 13 12 23 23 20 19 14 14 12 12 16 19 17 16 13 12 10 6 2 1 -2 -2 -1 0 -1 -3 -9 -9
 23 21 20 23 25 27 23 27 27 22 17 13 14 9 9 11 9 8 16 22 21 28 28 31 26 30 34 37 39 39 29 27 23 19 22 21 4 0 0 -4 -7 -12 -14 -15 -19 -20 -21 -19 -21 -20 -19 -17 -10 -3 0 -4 -4 -4 0 -3 -5 2 5 8 11 7 2 13 18 22 26 20 18 16 25 25 25 21 16 19 10 12 17 19 16 13 13 9 12 8 2 0 -7 -5 -4 0 -1 -6 -7 -11
 21 24 25 22 25 26 24 25 25 24 18 14 13 9 8 10 14 15 18 22 23 31 29 28 26 34 38 39 40 38 33 31 32 24 21 22 5 5 2 -5 -8 -9 -10 -13 -12 -10 -14 -22 -23 -18 -11 -11 -5 0 3 -1 0 1 1 6 7 5 12 16 15 13 9 20 30 33 32 29 23 23 27 27 28 22 14 13 11 16 16 17 18 12 12 11 8 7 1 -1 -5 -4 -2 -1 -5 -10 -13 -15
 28 29 27 27 29 29 25 23 26 22 19 16 11 6 7 14 16 16 17 17 23 26 29 31 33 36 36 41 40 39 36 34 30 24 22 23 11 9 5 -2 -7 -8 -7 -12 -11 -8 -17 -23 -23 -12 -10 -10 -1 0 2 2 4 4 10 12 12 14 14 17 18 16 16 27 33 30 31 26 21 24 32 30 30 19 13 14 13 15 18 18 18 14 12 12 8 2 1 0 -3 -3 -1 -3 -7 -11 -13 -17
 29 28 25 32 30 27 26 25 25 22 21 15 13 12 10 16 15 16 16 20 24 25 30 29 37 34 38 41 43 37 37 35 34 22 22 24 13 14 7 1 -3 -3 -8 -6 -7 -6 -12 -17 -15 -8 -5 -7 -1 1 1 4 5 6 9 15 17 20 19 20 22 21 21 28 30 36 33 30 26 27 33 30 30 22 19 18 14 15 15 17 14 13 9 7 8 2 1 -2 -4 -4 -6 -5 -11 -11 -17 -18
 30 32 35 32 34 33 38 38 43 41 39 36 35 32 30 24 21 20 20 28 28 29 30 32 36 32 29 24 19 19 17 10 4 0 -5 -5 -10 -6 -1 2 2 2 3 0 -2 -5 -7 -10 -12 -4 -1 0 2 8 12 16 18 17 19 23 24 29 27 29 29 29 32 33 35 35 38 35 33 35 34 29 32 28 28 29 27 25 23 18 16 15 10 8 5 0 -1 -3 -2 -10 -10 -14 -15 -17 -18 -21
 33 33 33 35 35 36 41 41 43 42 38 35 34 35 32 25 22 24 29 33 34 34 32 33 36 32 31 22 20 20 15 10 5 0 -5 -7 -7 -8 -2 2 2 3 0 -3 -5 -4 -6 -10 -11 0 -2 0 4 7 10 15 19 18 20 24 25 25 25 25 25 26 29 33 36 37 39 36 33 37 30 29 30 30 27 27 29 28 23 20 20 17 12 11 5 -2 -2 -1 -9 -12 -13 -15 -17 -17 -22 -25
 40 37 36 38 40 43 42 47 46 45 41 37 35 34 33 30 27 26 28 32 32 32 35 35 34 31 27 24 20 18 15 11 7 2 -4 -6 -5 -6 2 -1 0 -2 -3 -3 -5 -5 -6 -10 -9 4 -2 -3 1 6 9 11 15 14 19 23 25 19 19 22 22 24 27 32 33 37 39 31 36 39 30 30 31 30 27 28 28 26 24 23 21 16 12 8 5 -2 -2 -3 -9 -11 -15 -15 -17 -18 -24 -30
 42 43 42 41 44 43 47 43 46 46 41 37 36 36 39 32 31 26 30 34 38 38 33 30 35 31 28 23 20 18 19 13 6 1 -3 -6 -3 0 0 0 -3 -2 -2 -3 -6 -4 -7 -3 -5 4 1 0 3 11 12 9 12 14 15 18 23 14 18 18 19 22 26 33 33 40 36 38 36 39 30 28 27 29 29 27 29 26 25 23 16 17 9 5 -1 0 4 0 -8 -9 -13 -17 -21 -25 -31 -36
 42 43 41 42 43 43 42 38 44 41 40 37 38 36 35 36 33 29 34 35 36 32 31 33 36 36 31 24 20 20 17 13 10 0 0 -2 -4 -3 -2 -6 -8 -5 -4 -2 -3 -4 -4 -2 -6 3 1 1 10 15 16 13 13 15 15 18 21 15 19 18 19 19 23 29 30 35 33 30 32 38 25 24 26 30 31 32 26 26 25 18 14 15 9 6 3 5 7 1 -10 -9 -13 -18 -22 -28 -31 -37
 40 40 41 41 44 49 41 43 41 40 37 38 41 39 35 36 32 31 33 30 36 30 28 30 37 35 33 27 24 23 20 16 10 5 1 -3 -6 -4 -4 -10 -7 -8 -6 -4 -2 -5 -3 -6 -4 5 6 8 13 14 11 13 11 11 15 17 18 15 15 17 20 18 23 24 27 34 33 34 36 41 25 24 25 24 29 30 27 26 24 22 18 17 13 9 5 2 -1 -1 -12 -14 -20 -22 -24 -30 -33 -37
 41 49 52 53 53 52 47 48 48 45 42 37 42 39 34 34 34 31 28 33 33 33 32 31 35 35 33 34 31 27 20 16 13 10 9 6 -5 -5 -6 -6 -5 -6 -6 -6 -6 -7 -7 -9 -5 10 10 11 13 9 12 11 17 15 19 20 16 11 15 22 20 22 20 24 33 33 39 39 40 44 22 28 30 28 28 30 27 22 23 20 20 18 11 8 5 2 -2 -6 -16 -20 -25 -27 -32 -38 -37 -41
 48 52 52 56 56 52 49 49 49 43 41 40 41 40 39 38 36 35 35 39 37 34 32 32 36 37 36 33 31 29 20 19 16 15 13 9 0 -1 -2 -5 -3 -2 0 0 -4 -2 -6 -10 -7 8 9 11 10 9 11 13 16 15 15 16 15 13 15 18 19 22 23 29 35 37 38 42 41 43 26 30 29 28 29 30 23 19 20 20 21 18 12 10 6 0 0 -7 -19 -21 -24 -26 -34 -38 -40 -45
 48 53 55 59 56 55 49 50 47 42 42 39 41 39 40 40 40 34 40 40 36 36 32 33 40 37 34 34 29 25 20 20 21 17 15 13 5 1 -1 4 1 -1 -2 1 1 0 -4 -7 -5 10 9 10 7 9 11 15 11 13 10 13 16 11 13 14 19 23 26 27 37 38 39 40 44 45 28 30 30 30 30 30 26 21 22 21 20 23 7 8 9 0 -2 -8 -19 -23 -23 -27 -32 -37 -43 -47
 53 58 60 57 56 57 54 52 52 43 44 38 43 41 45 41 43 39 39 40 39 39 36 34 38 36 35 31 27 28 23 26 22 21 19 16 6 7 4 5 8 5 3 4 4 3 0 2 -4 10 12 13 10 10 8 6 8 8 9 8 5 5 12 13 18 22 24 30 38 38 41 42 43 43 29 29 32 31 30 28 23 21 20 21 22 22 9 6 4 -2 -7 -8 -20 -27 -29 -31 -36 -35 -40 -48
 57 59 62 59 58 58 54 54 49 45 47 42 45 44 45 45 45 44 42 42 41 37 34 35 37 36 35 33 30 31 29 29 28 27 24 20 16 15 11 15 13 13 8 7 4 5 6 4 2 13 12 11 8 9 7 5 5 6 2 4 6 4 8 12 21 24 24 33 36 38 39 42 44 42 24 25 27 26 29 26 21 20 22 23 25 20 10 8 4 -4 -7 -11 -25 -32 -35 -33 -35 -34 -45 -48
 58 61 63 63 61 59 59 55 51 45 45 46 43 45 49 48 46 48 42 47 42 40 37 37 40 39 36 28 34 32 30 33 33 32 26 25 22 21 19 17 18 17 12 9 12 6 7 1 2 10 10 6 11 6 4 2 1 5 3 2 1 0 9 12 15 22 24 31 33 38 37 39 43 40 25 26 21 24 27 23 22 21 24 20 23 23 11 8 6 -5 -7 -12 -24 -30 -32 -34 -36 -38 -42 -51
 64 63 64 64 63 61 60 56 51 50 47 47 46 42 40 39 44 44 46 42 41 38 35 32 40 36 35 32 32 33 30 31 32 32 29 26 26 26 22 21 20 17 13 13 11 6 5 6 7 6 4 3 3 0 0 0 -1 -3 -4 0 0 2 1 3 3 7 10 11 19 23 30 30 30 34 23 21 18 16 17 21 18 21 23 22 17 20 16 6 3 -1 -8 -16 -19 -21 -28 -30 -33 -36 -42 -49
 65 65 64 67 67 64 58 54 52 48 47 46 42 40 40 43 44 43 45 42 40 36 34 34 41 37 34 35 30 30 32 30 33 33 31 29 29 26 25 24 22 21 17 17 12 7 7 6 9 5 7 6 4 1 2 1 0 -4 0 3 1 2 0 0 4 8 7 10 13 22 27 27 30 31 19 23 19 21 20 22 22 22 22 17 14 18 11 7 5 -1 -6 -9 -17 -18 -25 -30 -32 -35 -39 -46
 65 66 70 69 68 69 59 57 50 48 47 47 46 39 40 43 41 42 42 44 41 39 37 36 42 41 43 38 34 34 33 31 34 34 33 36 32 28 27 23 23 22 16 15 12 8 8 10 14 8 7 9 2 2 6 2 0 -2 4 3 1 2 1 -1 1 3 5 9 16 23 24 29 26 30 22 21 22 21 25 28 18 22 18 21 17 17 10 8 8 2 -2 -6 -14 -20 -27 -29 -30 -35 -36 -43
 66 72 71 73 68 68 61 56 54 47 47 47 41 38 42 41 42 43 45 44 42 38 39 37 45 42 46 40 33 36 35 38 39 36 39 34 33 31 32 25 23 21 17 15 11 14 15 24 26 9 16 11 9 10 7 3 4 1 1 4 4 3 1 0 1 1 1 9 15 19 21 22 23 21 17 18 23 23 27 29 24 24 21 20 18 20 11 12 11 7 3 2 -15 -17 -22 -22 -26 -26 -30 -34
 70 74 73 72 68 67 61 56 53 48 44 45 37 38 41 41 44 45 48 48 44 39 39 39 42 40 41 34 33 35 40 44 41 39 41 37 35 35 32 26 22 20 18 18 17 17 22 26 25 18 19 16 12 10 10 9 10 6 6 7 8 0 1 0 -2 -1 3 7 10 13 18 19 22 21 16 19 21 24 28 29 24 26 25 18 16 18 12 14 14 9 7 4 -6 -9 -14 -16 -20 -23 -27 -31
 75 74 72 72 71 72 62 61 58 50 47 50 35 37 42 42 44 50 46 47 43 44 41 44 46 42 38 38 36 39 42 41 42 39 39 34 37 37 33 28 26 24 16 19 17 20 21 26 27 19 19 19 16 17 14 8 9 5 13 9 5 -1 2 -1 0 -1 1 6 7 10 14 18 19 19 11 15 18 25 28 29 26 27 24 20 17 15 13 13 15 12 9 7 4 -7 -9 -13 -14 -16 -21 -26
 74 74 73 75 72 71 66 62 61 57 51 48 35 39 44 43 44 43 47 46 41 41 43 45 43 39 36 38 38 41 39 38 39 42 42 41 35 33 32 28 24 27 22 22 21 22 22 26 24 21 18 18 17 16 16 11 11 14 11 10 7 0 2 0 -1 2 3 3 7 6 7 10 10 13 10 16 15 21 23 27 27 25 27 24 20 13 13 12 11 10 9 10 5 -6 -11 -13 -13 -17 -20 -21
 74 75 74 74 73 70 61 57 57 49 45 44 37 37 40 40 40 43 43 46 42 41 41 45 42 39 41 39 40 36 37 35 40 42 45 42 37 37 34 29 27 25 23 21 23 22 24 27 27 21 16 17 16 16 13 10 8 9 9 11 8 4 6 4 4 4 4 7 9 8 7 10 12 14 14 15 17 21 20 23 24 26 25 23 21 15 10 8 5 5 5 6 0 -8 -11 -14 -15 -16 -19 -21
 74 73 73 69 70 65 59 56 53 50 43 40 36 40 43 39 41 43 42 40 38 40 43 49 47 44 42 39 38 39 35 39 39 43 47 45 42 37 36 31 30 24 28 23 25 23 19 20 20 20 19 17 16 12 11 11 8 10 8 6 1 6 7 7 8 6 4 5 9 5 10 11 12 11 13 16 18 19 18 19 19 22 24 21 19 11 13 7 5 0 2 9 0 -7 -8 -14 -13 -15 -18 -18
 70 68 70 65 62 61 53 51 49 44 43 40 39 40 40 42 44 42 37 38 38 43 46 49 45 42 39 38 34 37 39 40 42 43 44 43 39 39 36 31 30 29 25 23 23 23 23 23 22 23 21 20 12 12 9 7 7 4 1 -2 -1 7 9 11 9 10 11 8 9 8 9 10 9 12 17 18 17 17 15 14 20 21 24 18 16 12 9 6 3 1 2 2 -4 -8 -11 -15 -14 -16 -15 -15
 75 74 74 68 61 62 52 54 51 46 41 41 36 38 37 40 40 37 33 39 34 41 44 44 47 40 41 40 39 40 36 40 41 44 43 45 36 39 39 31 30 32 29 26 26 24 22 23 26 25 23 22 10 10 10 6 5 4 3 1 -2 5 9 8 9 8 8 11 11 12 12 9 5 9 16 12 15 13 9 11 19 17 19 14 12 9 10 5 3 0 2 3 -3 -3 -7 -15 -14 -12 -15 -14
 77 78 74 63 62 60 54 54 52 41 40 39 36 36 36 38 37 40 38 38 38 42 42 43 41 39 40 42 40 39 41 41 41 43 44 43 36 35 35 31 29 30 31 30 31 28 25 24 25 26 26 21 10 9 7 6 7 4 7 6 3 7 9 13 8 9 9 14 14 15 13 8 3 8 7 6 9 6 5 3 14 15 12 8 9 9 6 7 0 1 3 0 -3 -1 -9 -13 -10 -9 -11 -13
 75 76 70 66 64 64 50 52 52 43 44 42 38 34 37 36 37 35 36 40 41 40 43 46 43 41 41 38 39 42 44 41 40 46 42 42 34 35 32 33 31 34 32 32 31 32 29 25 27 24 23 21 11 10 10 8 6 9 7 6 2 7 7 7 9 9 11 13 14 13 15 14 8 9 6 6 4 4 2 0 6 4 2 4 5 6 3 2 0 0 0 -4 -8 -5 -11 -14 -9 -10 -9 -11
 75 71 68 69 66 62 65 60 60 58 49 44 41 41 42 41 42 40 38 35 37 39 40 36 40 44 43 47 45 45 44 41 41 40 37 39 38 36 37 38 33 30 27 20 20 22 25 25 29 25 22 21 24 22 23 23 20 20 19 19 16 18 20 21 22 20 20 21 19 16 14 13 7 6 4 3 2 4 1 -2 -2 -2 -1 -1 -2 -3 -5 -3 -3 -2 -2 -2 -5 -8 -11 -10 -12 -11 -9 -7
 68 70 67 65 65 65 63 59 59 50 45 41 40 42 42 40 41 38 33 34 36 38 40 41 40 41 45 45 44 45 44 44 41 41 40 40 38 36 36 32 30 27 20 17 18 24 25 26 28 23 20 24 24 22 23 25 22 21 18 21 18 22 19 22 23 22 21 19 17 13 14 7 4 2 1 1 4 0 1 0 -4 -5 -4 0 0 0 -2 -4 -4 -1 2 -1 -7 -9 -11 -10 -10 -11 -8 -4
 61 66 68 61 63 59 63 61 59 50 45 45 39 36 39 32 35 36 33 34 37 34 38 39 40 42 49 50 46 45 45 44 43 46 41 43 40 37 38 33 30 25 17 18 18 23 23 26 30 29 23 25 24 22 24 27 22 23 17 19 18 24 23 22 24 24 23 17 15 17 13 10 2 1 -1 0 0 0 1 0 -6 -3 0 1 0 -1 -1 -2 -7 2 0 -5 -7 -8 -10 -10 -10 -7 -4 -2
 62 59 58 61 60 55 60 56 56 50 39 39 32 32 35 31 29 29 32 33 35 34 38 40 44 45 48 49 47 50 46 44 44 45 44 44 40 35 32 32 23 22 21 24 21 27 32 32 30 29 31 26 24 23 22 27 23 24 19 20 22 28 23 23 25 24 24 17 19 14 10 6 2 0 -1 -2 0 0 1 0 -1 0 -1 -1 1 1 2 0 -3 -2 -1 0 -6 -7 -8 -6 -6 -3 -4 -1
 57 57 58 56 57 56 52 52 48 39 37 36 28 29 28 24 25 26 27 31 31 37 40 41 42 43 47 47 48 49 44 44 47 44 42 42 35 31 31 26 21 20 22 26 27 29 31 32 31 32 32 27 22 22 21 22 21 20 21 22 22 23 20 23 28 26 25 20 19 14 8 7 1 -3 -4 -3 -2 1 1 2 0 0 0 0 2 2 1 1 0 -1 -1 0 -6 -6 -7 -3 -2 -3 -2 -2
 53 55 53 50 53 55 46 49 45 38 36 33 29 26 22 19 23 24 23 28 35 33 37 41 43 42 42 45 48 52 44 47 41 46 45 44 35 34 31 24 21 17 24 26 24 30 32 35 36 29 29 29 21 24 24 22 22 19 21 23 24 24 23 22 31 28 25 19 18 14 8 1 0 -3 -6 -3 0 0 3 2 1 2 4 6 5 6 5 2 5 0 -2 -2 -5 -5 -2 -3 1 -2 -1 -3
 50 46 45 46 47 48 48 47 44 45 33 32 23 26 25 27 23 23 22 25 30 33 37 39 39 37 43 42 45 47 49 44 47 45 44 44 37 30 29 28 26 25 24 24 24 25 28 31 36 29 25 28 29 26 26 22 24 28 28 27 27 26 29 28 27 28 25 19 12 8 3 0 -3 -9 -5 -4 -3 0 0 -2 3 7 5 7 13 12 6 2 0 -1 -1 -3 -4 -7 -8 -9 -8 -5 -4 -6
 45 43 44 46 46 48 44 44 43 33 30 27 25 26 29 25 22 20 22 23 26 34 36 36 36 34 39 42 44 46 42 39 42 41 41 42 35 31 32 31 28 27 28 25 26 24 26 30 32 29 26 30 29 26 26 26 27 30 30 28 30 31 31 28 26 26 24 15 11 7 3 -1 -3 -8 -6 -6 -1 -3 -2 -4 5 6 6 11 16 11 8 2 0 -1 -2 -6 -6 -6 -10 -9 -7 -5 -7 -9
 42 43 43 42 43 42 42 39 37 31 27 24 24 28 27 22 23 26 23 25 23 33 36 37 38 34 35 37 39 43 39 38 43 43 40 47 33 33 37 35 30 27 32 28 25 27 28 30 34 31 30 25 32 26 26 30 29 25 30 31 29 30 31 25 24 22 24 17 9 9 5 -1 -3 -7 -8 -7 -6 -3 -3 -5 7 4 4 7 11 11 11 3 0 -3 -4 -5 -10 -9 -8 -11 -10 -9 -10 -12
 42 40 40 41 40 37 38 33 31 24 21 19 23 27 28 27 23 23 23 26 28 32 36 35 35 32 36 36 37 36 36 38 41 43 40 42 37 40 37 35 33 33 34 36 31 32 34 35 36 31 29 34 31 29 26 28 29 31 33 33 34 32 30 28 24 19 18 12 9 5 1 0 -10 -9 -10 -6 -6 -3 -4 -1 3 0 2 6 9 12 11 6 0 -6 -4 -8 -10 -9 -13 -13 -15 -15 -14 -17
 42 39 38 37 37 36 32 32 26 18 16 15 18 21 23 21 23 24 24 26 29 35 37 40 31 30 31 34 36 34 34 35 38 40 38 40 42 40 40 37 36 38 38 40 37 35 35 36 35 31 28 29 29 30 27 28 27 28 31 34 36 32 30 29 22 22 19 12 9 6 1 -3 -10 -11 -14 -10 -9 -5 -3 -3 0 -1 3 7 9 12 11 8 4 0 -3 -8 -11 -10 -12 -15 -16 -14 -17 -21
 41 37 38 37 36 31 30 29 28 16 12 7 17 17 15 16 20 24 24 26 31 37 35 37 30 30 31 30 30 28 33 35 38 39 38 39 39 41 37 42 40 41 43 40 40 37 35 37 36 32 30 28 30 29 24 28 25 34 34 35 36 36 32 27 22 21 19 11 9 8 2 -3 -8 -8 -17 -13 -13 -4 -5 -2 2 2 2 9 12 14 9 8 5 0 -5 -7 -11 -11 -16 -18 -16 -18 -23 -23
 42 35 35 34 28 29 29 24 20 19 17 14 11 13 15 17 21 24 24 27 28 30 37 37 29 31 31 32 36 35 32 36 42 41 46 45 44 46 48 46 46 46 45 45 43 44 43 41 41 35 37 42 41 41 38 40 40 41 40 41 39 37 37 37 33 31 30 28 20 15 14 8 0 -5 -20 -15 -8 -7 -4 -6 0 5 9 10 11 13 14 8 7 4 -2 -2 -3 -10 -14 -16 -20 -19 -22 -26
 38 32 30 25 22 24 22 21 19 21 19 16 14 16 17 20 21 21 27 26 29 35 37 36 32 35 35 37 38 36 39 39 42 49 48 46 48 51 50 49 46 46 47 46 47 45 45 42 39 37 39 41 39 40 37 36 39 39 41 43 40 40 38 35 33 32 30 26 19 17 15 8 -1 -4 -17 -14 -13 -5 -4 -1 7 7 9 7 6 10 12 10 7 -3 -5 -6 -5 -8 -15 -15 -16 -19 -23 -24
 38 31 25 24 20 26 23 21 22 20 20 19 15 16 16 17 23 23 28 28 35 38 37 42 34 37 37 41 40 38 43 44 45 52 51 53 49 52 55 52 50 48 49 51 51 46 50 42 37 37 39 42 35 38 33 34 37 39 43 42 42 42 40 37 33 32 30 25 22 17 15 5 0 -3 -15 -16 -11 -3 -3 1 8 7 9 9 7 12 12 10 3 1 0 -3 0 -7 -12 -14 -14 -16 -21 -23
 37 31 27 20 17 17 20 19 21 22 21 17 16 17 18 21 23 24 27 33 34 37 40 39 36 42 45 42 40 40 46 52 54 56 61 57 53 57 59 56 55 54 53 51 54 49 45 45 41 35 34 34 34 31 29 33 33 33 40 44 50 43 37 37 33 33 28 29 20 15 16 8 6 0 -13 -10 -12 -4 -1 4 9 11 13 9 10 14 13 3 3 1 0 0 -2 -6 -11 -11 -10 -15 -14 -19
 34 31 25 18 14 12 18 18 20 20 19 20 20 20 20 23 24 25 29 35 33 39 40 42 40 44 45 42 40 43 50 53 56 61 63 65 56 57 57 59 58 56 51 48 49 47 47 46 38 34 32 32 27 25 26 30 32 35 39 43 48 41 37 38 38 35 31 25 18 16 17 11 7 0 -9 -8 -6 -1 -3 2 9 8 8 7 9 7 4 1 2 0 0 -3 0 -2 -5 -8 -11 -12 -15 -18
 36 31 25 13 15 12 12 14 22 22 20 23 24 22 22 24 28 29 33 33 33 37 40 42 40 43 41 43 45 46 53 55 55 64 64 67 56 57 56 59 59 56 54 50 51 46 43 44 37 31 32 29 23 22 25 27 30 32 36 40 46 44 40 36 33 36 33 26 22 18 15 8 8 0 -9 -3 -2 4 3 5 9 9 7 8 5 5 7 2 3 0 0 0 0 -1 -4 -6 -5 -11 -13 -15
 33 26 25 19 13 8 10 17 18 17 19 21 22 24 27 27 29 32 31 38 38 39 43 44 41 43 44 48 50 53 55 61 66 67 66 67 56 59 57 52 57 56 52 46 41 43 43 42 39 34 28 29 27 24 22 25 32 37 41 45 45 43 38 33 33 31 30 29 23 23 20 16 8 2 -4 0 -1 4 6 10 9 7 6 3 5 0 7 2 2 2 4 4 2 0 -3 0 2 -1 -4 -10
 29 27 25 17 16 13 16 20 19 18 18 19 21 24 27 29 29 30 34 37 37 43 44 45 43 44 45 49 51 52 60 64 66 66 64 65 63 61 57 54 55 54 49 45 44 44 44 43 39 28 25 29 30 25 26 32 35 39 44 45 48 41 39 36 31 30 31 33 25 21 22 15 7 6 1 2 3 7 8 9 8 10 6 2 4 0 0 -1 0 0 3 4 2 0 1 1 1 0 0 -6
 29 28 23 22 18 17 15 17 20 17 19 24 24 26 27 28 31 31 34 38 40 43 43 40 43 41 45 45 49 49 60 64 66 71 66 65 64 62 58 54 55 54 47 44 44 46 45 43 39 33 32 31 34 30 30 35 39 41 48 48 44 40 38 34 33 32 38 33 28 25 21 19 11 8 4 5 5 8 8 12 3 7 6 0 0 3 0 -2 0 0 1 5 7 3 2 2 3 0 -2 -6
 29 28 27 22 21 20 16 16 16 20 20 22 28 31 31 33 32 32 36 37 40 43 43 43 43 44 46 50 52 52 62 64 65 71 70 68 63 61 57 51 51 49 49 47 47 45 40 38 35 37 39 38 35 33 30 41 44 46 49 52 50 41 38 37 36 38 38 32 28 25 21 18 13 11 4 3 4 7 7 4 5 4 4 -2 -4 -2 -3 -2 -3 0 1 2 4 2 3 4 1 0 -1 -2
 31 28 31 26 25 28 19 18 20 14 18 22 25 27 30 32 33 30 35 40 38 41 40 43 47 45 47 51 52 54 59 58 66 67 70 68 66 63 60 49 52 48 50 49 45 47 45 37 40 40 37 38 33 34 34 42 44 45 43 48 46 41 37 38 35 35 37 30 28 29 22 20 19 16 6 6 9 10 8 7 4 6 4 0 -5 0 0 0 3 1 3 8 3 1 1 0 1 0 -3 -1
 30 31 29 29 27 25 23 23 21 17 17 19 22 22 26 32 33 33 37 41 41 44 42 46 43 44 45 54 54 54 59 58 62 70 70 70 67 67 62 53 52 51 48 49 44 45 42 39 38 35 36 38 34 32 34 42 43 45 43 43 46 40 39 37 35 34 36 29 29 27 20 21 23 18 13 11 12 12 11 12 6 6 6 -1 -3 -3 0 1 1 3 4 6 0 0 2 -2 -2 -2 -1 -1
 35 34 34 31 29 28 20 23 23 18 19 18 17 20 22 28 28 29 35 35 38 44 43 44 47 47 46 52 53 55 59 57 57 64 65 63 67 64 58 53 51 53 47 49 47 45 41 39 37 37 36 36 38 37 37 43 42 41 45 40 40 43 39 35 33 33 34 33 28 26 22 24 20 15 14 16 14 13 12 11 4 6 5 0 0 -1 -1 1 2 6 6 8 1 0 0 -1 0 -4 -6 -4
 35 35 34 33 32 32 31 38 35 36 40 38 42 43 45 45 51 51 50 49 46 47 47 49 48 46 48 50 49 48 52 52 54 53 51 48 52 43 42 39 40 44 43 42 39 37 40 44 42 40 34 32 36 37 38 34 31 32 30 29 28 30 29 29 31 26 27 24 22 22 22 20 16 16 17 12 11 12 7 7 5 1 -3 -6 -11 -12 -15 -13 -10 -12 -13 -12 -12 -9 -7 -11 -9 -7 -10 -8
 39 39 38 39 36 36 38 41 39 43 44 43 43 44 45 47 50 50 48 49 47 45 47 45 45 44 49 48 46 49 50 51 52 52 52 49 43 37 36 37 42 44 43 41 39 37 42 46 42 35 34 35 37 37 38 33 31 30 28 27 27 30 30 32 28 23 23 23 21 22 22 18 14 17 13 10 11 7 6 6 6 1 -2 -8 -10 -11 -11 -13 -13 -13 -14 -12 -9 -8 -10 -14 -11 -7 -10 -12
 38 39 38 44 41 39 42 43 39 47 44 49 46 45 46 46 49 48 44 50 46 41 45 48 41 47 50 49 51 56 53 53 55 49 51 52 42 36 29 37 40 43 42 38 34 35 39 40 38 37 35 32 40 37 41 35 30 30 27 27 30 29 30 31 29 23 21 21 18 18 19 19 15 18 15 11 10 10 8 10 8 3 -3 -6 -8 -12 -10 -11 -12 -9 -11 -10 -8 -5 -12 -13 -8 -12 -11 -15
 39 44 47 46 44 41 45 45 47 49 49 50 45 42 41 44 44 45 48 46 47 45 45 44 46 48 49 52 53 50 50 49 49 50 48 48 42 33 26 33 42 44 42 39 40 35 33 36 33 34 40 39 41 41 41 35 35 30 30 31 28 29 29 31 28 27 23 20 13 12 15 18 21 23 14 13 11 10 8 8 8 2 1 -5 -5 -5 -7 -4 -5 -8 -8 -11 -6 -10 -12 -15 -17 -16 -15 -19
 42 44 48 46 44 46 48 47 50 49 49 47 41 40 41 43 44 42 43 43 43 43 45 42 42 47 48 50 53 52 48 48 50 47 47 48 34 32 33 40 42 45 42 39 40 36 37 37 32 41 43 44 42 41 40 37 36 33 33 32 31 30 31 30 27 29 25 14 11 15 18 19 22 22 14 13 11 7 5 9 7 5 1 -2 0 -4 -3 -1 -4 -6 -7 -6 -8 -13 -14 -16 -16 -16 -18 -21
 45 44 52 51 49 48 49 49 54 47 49 47 41 39 37 40 41 44 42 39 43 41 43 44 35 41 43 45 50 49 47 49 47 44 46 43 36 38 32 43 44 45 40 37 40 34 34 33 25 36 41 41 46 42 41 38 35 36 30 31 30 28 28 28 28 26 22 17 17 19 20 23 21 26 11 10 7 5 7 6 8 7 2 0 0 -3 -1 -3 -4 -4 -6 -2 -10 -12 -17 -16 -16 -18 -19 -23
 44 50 48 47 51 50 51 47 49 48 47 46 39 42 39 37 39 43 40 41 41 41 37 33 34 36 37 35 44 42 48 43 45 42 44 44 39 41 36 42 47 45 42 34 32 29 27 27 25 36 37 38 40 42 44 37 32 31 30 27 26 26 22 19 22 21 17 22 21 23 22 19 25 23 9 12 14 15 10 11 9 11 9 5 5 0 -1 5 2 2 0 -3 -10 -13 -18 -20 -15 -14 -17 -20
 51 54 51 50 51 53 49 47 47 50 48 49 44 45 39 38 40 42 40 41 39 38 37 37 34 36 37 38 43 45 40 41 40 43 45 42 40 40 40 41 46 42 34 31 29 28 28 27 24 35 35 37 41 44 42 34 31 32 31 29 28 23 20 19 21 20 20 21 21 22 22 25 27 25 10 12 14 14 10 13 13 13 10 8 6 5 8 9 10 4 3 0 -9 -10 -18 -16 -15 -11 -13 -17
 50 53 52 51 52 52 49 48 48 48 49 48 45 42 42 36 38 41 37 37 39 36 34 37 32 31 31 36 37 37 35 37 42 35 39 38 34 37 36 34 40 36 35 30 29 27 26 30 29 35 34 37 40 42 41 31 34 35 35 32 24 21 20 18 21 20 26 21 21 23 24 25 26 27 9 12 10 15 14 17 16 14 13 8 9 10 8 9 11 9 6 -1 -11 -12 -16 -14 -13 -13 -17 -16
 51 52 53 53 52 52 49 49 46 49 48 51 42 40 38 37 36 38 37 31 33 36 32 33 25 25 32 32 32 29 33 34 37 35 28 31 32 29 26 31 27 31 31 27 29 22 26 26 25 37 40 40 39 39 43 38 34 35 34 33 30 18 18 17 19 20 24 24 23 25 27 26 25 25 10 13 12 15 20 20 16 17 19 13 16 17 14 16 16 10 5 2 -9 -10 -11 -10 -10 -10 -13 -15
 49 51 51 50 51 48 48 47 48 46 46 50 46 45 40 36 35 36 31 28 33 33 33 32 22 22 26 28 28 28 31 32 32 28 23 23 26 25 27 23 23 24 24 24 24 21 23 26 25 39 42 39 41 40 43 37 35 35 32 33 31 17 18 16 19 21 21 26 25 27 28 26 25 27 13 12 14 22 20 21 20 19 20 19 20 19 19 18 16 7 6 3 -5 -7 -8 -9 -11 -9 -11 -13
 45 48 47 49 51 50 45 47 50 49 52 49 52 48 45 39 38 36 35 30 37 30 30 32 25 22 23 26 25 28 27 28 27 26 22 25 24 23 22 22 23 25 22 24 24 23 26 23 26 40 40 39 40 38 41 35 34 31 30 31 29 18 17 18 22 22 20 24 25 30 30 31 29 30 14 16 20 22 26 24 24 25 27 21 24 23 19 15 14 6 6 8 -2 -5 -4 -7 -8 -11 -13 -13
 44 41 42 41 43 43 48 44 45 49 49 52 51 44 41 38 26 25 21 17 15 16 14 16 21 15 15 16 14 14 15 15 15 19 15 17 20 19 20 20 25 23 26 22 24 18 17 20 21 40 37 40 35 32 33 34 28 32 29 24 21 19 17 18 14 14 18 19 22 24 27 31 34 34 18 19 23 22 17 14 12 19 17 20 20 17 18 7 5 9 5 2 0 -3 -5 -6 -6 -3 -7 -12
 40 38 37 37 36 38 42 41 41 39 43 45 43 44 39 25 21 19 14 13 13 9 11 14 10 7 9 9 12 12 11 10 14 12 11 15 15 16 17 21 26 23 22 19 17 18 21 21 22 35 33 34 29 28 30 28 24 25 24 21 20 13 15 13 12 15 18 18 21 26 27 29 35 34 19 18 21 20 18 15 17 19 18 20 22 20 6 2 4 3 4 0 -3 -3 -4 -7 -4 -1 -6 -12
 36 38 39 35 35 35 36 38 38 36 37 40 37 38 33 23 17 15 12 10 11 5 5 5 4 3 2 8 10 10 6 11 12 13 13 15 11 14 17 19 21 19 15 17 12 15 18 21 24 34 34 34 28 26 29 27 24 28 20 21 16 7 9 12 8 13 14 17 23 22 27 34 32 32 20 17 18 17 16 15 16 19 14 17 18 17 5 3 3 0 0 -4 -7 -3 -6 -6 -4 -2 -8 -11
 37 33 30 31 28 27 37 27 32 31 32 30 31 26 25 17 8 6 8 0 -1 1 2 4 0 -3 -1 4 6 8 8 10 9 10 12 15 10 10 11 17 14 12 13 9 13 12 13 15 19 29 25 24 28 24 23 26 22 22 19 16 15 4 2 2 9 15 18 17 23 24 26 24 30 27 19 19 19 16 13 15 16 16 17 15 12 17 2 -2 -3 -6 -8 -5 -6 -8 -6 -3 -4 -3 -3 -7
 32 30 27 22 19 23 23 22 21 28 30 28 26 26 21 8 1 2 0 -4 -3 -3 0 0 -4 -5 -3 3 4 3 6 9 8 8 11 10 5 7 9 13 12 14 7 6 11 11 13 14 21 20 18 20 19 20 20 19 17 18 14 15 14 2 2 4 13 15 18 18 22 24 25 29 30 28 22 20 22 18 14 13 14 13 13 11 10 12 -2 -2 -4 -12 -12 -9 -8 -10 -9 -1 -1 0 -4 -7
 30 29 21 18 18 19 20 20 18 20 22 24 23 21 14 8 3 4 -3 -4 -8 -6 -4 -5 -6 -7 -5 0 3 2 6 4 5 3 8 4 2 5 7 9 9 9 6 5 10 10 13 14 18 16 15 15 13 16 15 17 14 15 14 13 10 2 3 3 12 14 18 18 19 20 25 25 25 24 24 21 22 21 16 14 12 12 7 9 8 14 -4 -6 -11 -13 -11 -12 -8 -8 -5 -2 -2 0 -4 -5
 26 24 25 26 18 14 15 17 12 15 18 22 21 13 4 6 -1 -5 -7 -8 -8 -7 -12 -10 -9 -13 -10 -8 -5 0 0 0 3 4 3 5 1 5 5 6 4 4 5 7 8 11 14 10 13 10 6 3 6 5 7 12 9 10 8 4 9 -2 0 3 6 7 11 15 17 19 18 16 20 23 27 20 16 20 17 15 11 11 7 5 7 5 -10 -8 -4 -6 -4 -7 -8 -3 -5 -7 -7 -4 -3 -3
 19 21 24 19 16 14 15 15 15 15 17 17 14 13 8 0 -4 -6 -13 -12 -13 -15 -17 -17 -18 -19 -14 -11 -9 -5 -6 -2 0 -1 0 2 1 4 5 4 4 5 1 4 8 10 9 9 12 3 0 4 0 0 6 9 8 7 1 0 1 -6 -5 -2 0 2 4 11 16 15 18 18 19 19 19 18 17 16 15 12 9 12 7 3 6 7 -8 -8 -6 -2 -1 -6 -7 -3 -4 -7 -4 -4 -6 -4
 17 18 23 20 17 11 15 15 13 12 15 17 13 13 5 2 -3 -8 -15 -18 -17 -17 -22 -19 -21 -22 -14 -11 -10 -8 -7 -7 -6 -3 -2 -3 0 1 2 4 1 2 -6 3 9 10 11 9 10 2 0 1 -3 0 4 5 6 5 0 0 -2 -7 -8 -7 -5 -3 2 7 12 16 17 18 21 18 16 16 16 12 14 8 7 7 1 0 5 7 -8 -10 -6 0 -1 -2 -7 -5 -5 -6 -6 -1 -4 -2
 16 19 19 15 14 12 12 12 12 11 11 10 9 8 10 0 -7 -9 -21 -23 -23 -23 -23 -24 -21 -20 -16 -9 -7 -6 -10 -11 -9 -5 -4 -2 0 0 0 1 1 0 0 3 7 9 8 7 3 -2 -2 -5 0 1 3 2 0 0 -3 -6 -8 -11 -12 -11 -6 -2 -2 9 11 14 16 17 17 16 13 15 14 13 14 14 3 0 0 0 0 2 -8 -7 -6 -1 0 0 -6 -5 -8 -9 -8 -9 -6 0
 13 14 18 13 14 9 7 9 12 9 8 7 5 5 2 -3 -9 -14 -20 -24 -23 -24 -25 -26 -27 -26 -23 -15 -13 -14 -17 -14 -11 -7 -10 -6 -3 -2 -5 -1 -4 0 -2 0 3 6 3 0 0 -3 -7 -4 -1 1 3 0 -1 -3 -5 -6 -9 -10 -10 -13 -7 -6 -7 2 3 6 12 10 13 14 13 13 12 11 10 13 3 2 -1 0 1 2 -3 -5 -1 -3 0 0 -5 -5 -5 -8 -10 -4 0 -2
 10 11 11 14 15 10 5 5 7 6 6 4 5 2 0 -7 -10 -16 -23 -24 -28 -28 -27 -28 -32 -32 -28 -19 -19 -19 -24 -22 -19 -11 -10 -8 -9 -10 -9 -4 -5 -3 -3 -1 -1 3 -1 -5 -4 -6 -7 -5 -3 -1 1 -1 -3 0 -5 -6 -8 -7 -7 -9 -10 -9 -5 -2 -1 3 9 9 8 9 11 12 11 6 6 8 5 5 1 1 1 0 -5 -1 -4 0 0 0 -4 -4 -4 -9 -7 -2 -1 -1
 4 5 7 6 11 5 6 3 3 5 5 7 3 0 0 -6 -12 -17 -25 -26 -32 -31 -30 -31 -32 -36 -29 -24 -25 -27 -27 -24 -22 -15 -13 -9 -9 -9 -5 -7 -7 -4 -1 -2 0 0 -1 -5 0 -6 -7 -3 -3 -2 1 -2 -3 -2 -3 -8 -6 -7 -13 -13 -12 -9 -8 -4 -4 1 5 7 7 8 11 9 9 10 5 9 8 1 2 -1 -5 -5 -12 -5 -2 -3 -1 -2 -3 -3 -3 -5 -6 -1 0 -1
 1 1 1 4 4 5 5 4 3 5 7 4 1 0 -3 -10 -14 -18 -24 -29 -32 -34 -34 -37 -36 -34 -34 -32 -32 -32 -28 -25 -24 -18 -15 -11 -9 -9 -9 -7 -8 -8 -3 -2 -2 -3 -4 -6 -8 -8 -8 -5 -1 0 -1 -2 -2 -1 -3 -7 -11 -14 -14 -13 -12 -10 -9 -7 -6 -4 -1 2 6 6 6 4 5 4 4 5 4 2 -2 -7 -9 -11 -9 -8 -5 -3 -3 -2 -1 0 -2 -2 -1 0 -1 0
