 0 0 4 2 0 1 4 2 6 5 7 9 5 4 2 2 0 -2 -1 0
 2 -2 0 -2 -2 1 0 0 1 3 6 5 0 0 0 -4 -4 -3 -3 0
 5 1 -5 -5 -4 -5 -5 -4 -2 0 -3 -1 -5 -3 -6 -6 -8 -7 -4 -1
 7 3 -5 -8 -8 -10 -6 -8 -6 -1 -3 -4 -6 -8 -11 -11 -10 -7 -2 -2
 11 6 0 -7 -15 -11 -10 -10 -9 -3 -7 -8 -7 -8 -12 -13 -10 -7 -7 -3
 13 7 0 -8 -13 -17 -12 -13 -8 -6 -6 -4 -5 -6 -11 -10 -8 -9 -8 -3
 15 8 0 -5 -9 -13 -14 -10 -10 -8 -4 -1 -3 -5 -11 -10 -8 -4 -2 -3
 12 4 0 -5 -8 -9 -8 -6 -10 -10 -3 -5 -2 -5 -5 -5 -4 -3 -4 -3
 11 2 1 -3 -8 -9 -8 -9 -13 -9 -8 -9 -4 -5 -3 -4 -4 -4 0 -2
 10 10 10 8 6 0 -3 -11 -11 -13 -13 -14 -17 -15 -14 -12 -11 -7 -8 -3
 8 6 4 4 2 -2 -2 -12 -13 -11 -11 -13 -14 -14 -12 -9 -10 -8 -9 -6
 5 2 -1 0 0 0 -1 -7 -10 -11 -11 -13 -10 -10 -9 -8 -8 -11 -9 -7
 4 2 0 -1 -4 -4 -4 -5 -7 -6 -6 -9 -10 -12 -11 -9 -12 -12 -11 -7
 2 3 0 -5 -6 -2 -3 -6 -4 -8 -8 -6 -12 -12 -13 -5 -11 -12 -12 -8
 3 3 1 -3 -5 -5 -5 -6 -7 -7 -7 -11 -9 -13 -11 -15 -14 -9 -7 -10
 2 4 1 0 -6 -5 -3 -5 -4 -8 -7 -1 -4 -6 -10 -12 -14 -6 -8 -5
 1 2 1 -2 -7 -4 0 -4 -7 -12 -2 7 1 -6 -9 -11 -13 -7 -7 -2
 -1 0 -1 -6 -2 -2 -2 -4 -7 -6 0 3 3 1 -3 -3 -4 -4 -2 -1
 0 0 0 -3 -7 -4 -4 -4 -7 -5 -5 2 3 -2 -1 -2 0 0 -1 -3
 0 0 -1 -3 -3 -4 -4 -5 -6 -3 -3 -1 0 0 0 2 1 0 0 0
