 0 0 0 0 0 0 3 5 1 5 5 4 2 1 0 3 5 -4 -5 -1
 0 -3 0 0 0 0 1 0 3 2 0 0 -1 -2 0 -1 -2 -12 -8 -7
 -3 -2 0 0 0 -2 -2 1 1 -1 -3 -2 -3 -4 -1 -7 -11 -10 -9 -12
 -6 -4 -2 -2 0 0 -2 3 8 -4 -1 -5 -6 -4 -3 -10 -10 -10 -12 -14
 -8 -7 -4 -3 -1 0 1 0 2 -6 -4 -4 -6 -3 -4 -10 -13 -15 -12 -13
 -8 -6 -2 -2 2 0 0 -1 -2 -7 -6 -3 -6 -5 -6 -8 -14 -15 -13 -13
 -6 -2 -1 0 2 -1 -1 -2 -2 -10 -6 -4 -3 -3 -6 -12 -16 -10 -10 -13
 -2 0 3 3 0 -2 -1 -2 -2 -6 -3 -6 -5 -4 -8 -12 -11 -6 -8 -11
 -3 0 3 2 0 -3 -2 -3 -3 -7 -3 -5 -7 -6 -8 -14 -10 -6 -9 -12
 -1 0 1 0 3 2 1 -2 -3 -6 -5 -5 -7 -5 -9 -12 -11 -12 -10 -8
 0 0 -1 0 6 0 1 -2 -8 -5 -2 -4 -9 -8 -12 -12 -14 -10 -8 -3
 1 -1 -3 0 5 2 -2 -1 -2 -5 -4 -2 -9 -10 -13 -15 -16 -7 -4 -3
 4 1 1 3 3 0 1 2 -2 -3 -4 -6 -10 -11 -12 -11 -8 -4 -3 -3
 2 2 -2 0 7 1 3 1 -3 0 -3 -11 -11 -15 -15 -8 -5 -5 -3 -1
 5 6 6 5 3 2 2 -2 -6 0 -5 -9 -15 -15 -15 -9 -6 -2 0 -1
 3 0 2 5 2 0 0 -5 -4 0 -3 -8 -11 -14 -10 -10 -8 -3 -2 0
 0 0 -1 0 1 -1 -1 0 -3 -1 -4 -7 -7 -8 -6 -5 -7 -3 0 0
 0 0 0 0 2 0 1 -1 -2 0 0 -2 -5 -5 -1 -1 -1 -3 0 0
 -2 0 0 0 0 -2 0 -1 -3 1 0 3 0 0 0 0 -1 0 -2 0
 0 -1 0 -1 -1 -3 -3 -2 -3 1 5 4 3 1 3 2 0 0 1 0
