 0 0 0 0 0 0 0 0 0 0 1 2 2 2 3 3 4 4 4 5 5 6 5 5 5 2 1 1 0 0 0 -2 -2 -3 -4 -4 -4 -6 -6 -7 -8 -8 -9 -9 -9 -9 -10 -10 -10 -9 -10 -10 -10 -9 -9 -9 -8 -8 -7 -7 -7 -8 -6 -5 -5 -4 -4 -5 -4 -4 -3 -3 -2 -3 -3 -1 -1 0 -1 0 -1 -1 -2 -2 -3 -4 -3 -3 -3 -3 -2 -2 -2 -1 -1 -1 -1 -1 0 0
 0 0 0 0 0 0 0 0 0 0 0 0 2 2 2 3 4 3 3 4 4 4 3 4 3 1 1 0 0 0 0 -2 -3 -4 -5 -4 -6 -6 -7 -7 -7 -8 -9 -8 -9 -9 -10 -10 -9 -10 -10 -10 -9 -8 -8 -7 -7 -6 -6 -6 -7 -5 -5 -5 -3 -3 -4 -3 -3 -3 -2 -2 -2 -2 0 0 0 0 0 0 0 -1 -2 -2 -2 -2 -3 -3 -3 -1 -1 -1 -1 -1 -1 -1 -1 -1 0 0
 0 0 0 0 0 0 0 -1 -1 0 0 0 2 2 2 3 3 3 3 3 3 3 3 3 3 2 1 0 0 0 0 -2 -3 -4 -5 -4 -5 -6 -7 -7 -7 -8 -9 -8 -9 -9 -9 -9 -9 -9 -9 -9 -8 -8 -8 -6 -6 -5 -5 -5 -5 -4 -4 -4 -3 -3 -3 -2 -2 -2 -1 0 -1 -1 0 1 1 2 1 1 0 0 -1 -1 -1 -2 -2 -3 -2 -1 -1 -1 0 -1 -1 -1 -1 -1 0 0
 0 0 0 0 0 0 -1 0 -1 -1 -1 -1 1 2 2 2 2 2 3 3 3 2 3 2 3 1 1 1 0 0 0 -2 -3 -4 -5 -6 -6 -6 -7 -7 -8 -9 -8 -8 -8 -8 -8 -8 -9 -9 -9 -8 -7 -7 -6 -6 -4 -3 -4 -3 -4 -3 -2 -2 -2 -1 -1 -1 0 0 1 1 1 1 1 3 3 3 3 4 1 0 0 0 0 0 -1 0 -1 0 0 1 0 0 0 0 0 0 0 1
 0 -1 0 0 0 0 0 0 -1 -1 -1 -1 0 1 1 1 2 2 3 3 2 2 2 2 1 1 1 1 1 0 -1 -3 -4 -4 -5 -6 -6 -6 -7 -8 -7 -8 -8 -8 -8 -8 -8 -8 -9 -9 -8 -8 -7 -6 -6 -4 -3 -3 -2 -2 -2 -1 -1 -1 0 -1 -1 0 0 0 1 2 2 2 3 3 3 3 4 3 2 1 0 0 0 0 0 0 0 1 1 1 1 1 0 1 1 0 1 1
 0 0 0 -1 0 0 0 0 0 -1 -1 -1 0 0 1 1 2 2 1 2 1 1 2 2 1 1 1 1 1 1 -1 -3 -3 -5 -6 -7 -6 -7 -7 -8 -8 -7 -7 -7 -7 -7 -8 -8 -9 -9 -8 -7 -6 -5 -5 -2 -2 -2 -1 -1 -1 0 0 0 0 0 0 1 1 2 2 2 2 2 3 4 4 3 3 3 2 2 2 2 1 1 1 0 1 2 1 2 2 2 1 2 1 1 1 1
 0 -1 0 -1 0 0 0 -1 -1 -2 -3 -2 0 -1 0 0 0 0 1 0 0 0 0 0 1 0 0 0 0 0 -1 -4 -4 -5 -7 -7 -7 -8 -7 -7 -7 -8 -7 -7 -8 -8 -8 -8 -8 -8 -8 -7 -6 -4 -4 -2 -1 0 0 1 1 2 3 2 2 3 3 2 4 3 5 5 6 5 5 6 5 6 5 5 4 5 4 4 4 3 2 3 2 2 4 4 3 3 2 2 1 2 1 2
 -1 -1 -1 0 0 0 -1 -1 -1 -3 -3 -3 -2 -1 -1 0 0 0 0 0 0 0 0 0 0 0 0 -1 -1 0 -3 -4 -5 -6 -6 -8 -8 -8 -7 -8 -8 -8 -7 -7 -8 -8 -8 -8 -8 -8 -8 -8 -5 -3 -3 0 0 0 3 3 3 4 4 3 4 4 4 5 5 5 6 6 6 6 7 7 7 7 7 6 6 5 5 5 4 4 4 4 4 5 5 4 4 4 3 3 2 2 2 2
 0 -1 -1 -1 0 0 -1 -1 -2 -3 -4 -4 -2 -2 -2 -1 -1 0 0 0 0 -1 0 0 0 -1 0 -1 -1 -1 -3 -4 -6 -8 -8 -9 -7 -8 -7 -8 -8 -8 -8 -8 -8 -8 -9 -8 -9 -8 -8 -7 -5 -3 -2 1 1 2 4 4 4 5 4 4 5 5 5 6 6 6 6 6 6 6 8 7 8 8 8 7 6 7 7 6 5 5 5 5 5 6 5 5 5 4 4 3 3 3 3 2
 0 0 -1 0 0 0 -1 -2 -2 -4 -4 -4 -3 -3 -3 -2 -1 -1 -1 -1 -1 -1 -2 -1 0 -2 -2 -2 -2 -3 -4 -6 -7 -9 -10 -10 -8 -9 -8 -8 -9 -9 -8 -9 -9 -9 -8 -9 -8 -8 -7 -7 -4 -2 0 1 4 4 5 6 6 5 7 7 6 7 7 7 7 7 7 7 6 6 8 10 10 9 11 9 8 8 8 7 8 8 6 8 8 7 7 7 5 5 4 5 4 4 3 2
 0 0 0 0 0 0 -2 -2 -3 -4 -3 -4 -4 -4 -3 -3 -2 -2 -1 -1 -2 -2 -2 -2 -2 -3 -3 -3 -3 -4 -5 -5 -6 -9 -10 -10 -10 -10 -9 -9 -10 -10 -9 -9 -9 -9 -9 -9 -8 -7 -6 -6 -2 -1 0 3 4 5 6 7 7 8 9 9 8 8 8 9 8 8 8 7 6 6 10 11 11 11 12 11 10 10 9 9 9 9 9 8 8 7 7 7 6 6 5 5 4 4 3 2
 0 0 0 0 0 0 -2 -2 -3 -3 -3 -4 -4 -4 -3 -3 -3 -3 -2 -3 -2 -3 -3 -2 -2 -3 -3 -4 -4 -4 -5 -6 -6 -9 -10 -10 -10 -10 -10 -11 -10 -9 -10 -10 -10 -9 -8 -9 -9 -6 -5 -6 -1 0 0 3 3 5 6 8 8 10 9 9 9 9 9 11 9 8 8 7 7 7 10 11 12 12 13 12 11 11 10 10 10 10 10 9 9 8 8 8 7 7 6 6 6 4 4 2
 0 0 0 0 -1 -2 -2 -2 -3 -3 -4 -5 -5 -4 -3 -4 -4 -4 -3 -3 -3 -4 -4 -4 -2 -4 -4 -6 -7 -7 -8 -10 -9 -10 -10 -10 -11 -11 -10 -10 -10 -10 -9 -8 -9 -8 -9 -8 -8 -6 -3 -2 -1 0 1 3 4 5 6 8 8 11 10 11 10 11 12 12 11 11 12 11 11 10 12 11 11 10 9 9 8 10 10 11 12 12 11 9 8 8 6 5 4 3 3 4 4 4 3 2
 0 0 0 -1 -2 -2 -2 -2 -2 -4 -4 -5 -4 -3 -3 -3 -4 -3 -3 -3 -3 -4 -4 -3 -4 -4 -5 -7 -8 -8 -10 -10 -10 -11 -11 -11 -11 -11 -10 -11 -11 -10 -8 -8 -8 -8 -8 -8 -8 -4 -3 -2 -1 0 1 2 3 5 6 7 9 10 10 10 11 12 12 12 12 12 13 12 12 11 12 11 11 10 9 9 10 11 11 12 12 12 10 9 8 6 5 4 3 3 3 4 4 4 3 3
 0 0 1 -1 -2 -2 -2 -2 -3 -4 -4 -5 -4 -3 -2 -3 -4 -3 -3 -3 -5 -5 -4 -3 -4 -5 -6 -8 -7 -7 -9 -10 -10 -10 -11 -12 -11 -11 -11 -10 -10 -10 -8 -7 -7 -8 -8 -8 -8 -4 -3 -1 -1 0 0 2 3 5 6 7 9 10 10 10 11 12 13 13 13 13 13 13 13 13 13 12 10 9 9 9 10 11 12 12 12 11 9 9 7 5 5 4 2 3 3 4 5 4 4 3
 0 0 0 0 -2 -2 -2 -3 -3 -3 -6 -6 -3 -2 -2 -3 -3 -4 -4 -5 -5 -5 -6 -5 -5 -6 -7 -7 -8 -8 -10 -10 -10 -11 -11 -12 -12 -11 -10 -10 -8 -8 -8 -7 -7 -8 -8 -9 -8 -4 -3 -2 -1 0 0 1 3 4 6 6 7 11 11 11 12 14 15 14 14 14 15 15 15 15 14 13 12 10 9 8 10 11 11 12 12 13 10 8 7 5 4 3 2 3 3 4 3 3 3 3
 0 0 0 -1 -2 -3 -3 -4 -3 -6 -7 -7 -3 -2 -2 -3 -3 -3 -5 -5 -5 -7 -7 -7 -6 -7 -7 -8 -9 -9 -10 -10 -10 -12 -11 -12 -12 -10 -10 -9 -8 -7 -7 -7 -7 -8 -8 -8 -8 -4 -4 -3 -1 -1 0 1 2 3 5 5 7 11 11 12 13 14 14 14 14 15 15 15 16 16 15 15 13 10 9 8 10 11 11 12 12 13 9 8 7 5 4 4 3 2 3 3 3 3 4 4
 1 0 0 -2 -2 -3 -4 -4 -4 -5 -6 -7 -3 -2 -2 -3 -3 -3 -5 -5 -6 -7 -7 -7 -7 -7 -7 -9 -9 -9 -10 -10 -10 -12 -12 -13 -13 -12 -11 -9 -8 -7 -7 -7 -7 -8 -8 -9 -9 -4 -4 -4 -2 -1 -1 0 1 1 3 5 6 11 12 12 14 14 15 15 16 16 16 16 17 17 15 15 13 10 10 8 10 11 11 12 12 13 10 8 7 5 5 4 3 3 3 3 3 3 3 4
 0 0 -1 -1 -1 -2 -3 -4 -5 -5 -6 -7 -3 -3 -3 -3 -4 -5 -5 -7 -8 -7 -8 -9 -7 -8 -9 -9 -10 -10 -10 -11 -12 -12 -12 -13 -13 -11 -11 -10 -8 -7 -7 -8 -7 -9 -9 -9 -9 -4 -3 -2 -2 -1 0 0 1 3 3 6 7 11 12 13 14 15 15 16 17 17 17 17 18 18 16 15 14 13 12 11 10 13 13 13 13 14 9 8 7 6 5 5 4 4 3 4 5 5 5 4
 0 0 0 -1 0 -1 -3 -3 -4 -5 -6 -6 -3 -3 -3 -4 -5 -5 -7 -7 -7 -8 -8 -9 -8 -8 -9 -10 -10 -10 -12 -12 -12 -13 -12 -13 -12 -11 -11 -10 -9 -8 -8 -8 -9 -9 -9 -9 -9 -3 -3 -2 -1 0 0 1 2 2 5 6 8 11 12 13 14 15 15 17 17 17 18 18 18 19 17 16 15 14 13 12 13 14 14 13 13 13 9 9 8 6 5 5 5 4 4 5 5 5 5 5
 0 0 -1 -1 -1 -2 -3 -3 -4 -5 -5 -6 -3 -3 -4 -4 -5 -6 -7 -7 -7 -8 -9 -10 -9 -9 -10 -11 -10 -10 -11 -12 -13 -13 -13 -13 -12 -11 -11 -10 -10 -10 -9 -9 -10 -10 -10 -9 -9 -3 -2 -2 0 0 0 1 2 3 6 7 8 10 12 12 14 16 15 16 17 17 18 19 19 20 18 18 17 15 15 14 14 14 14 13 13 14 11 10 9 7 6 6 5 5 5 6 5 5 5 5
 0 0 0 -1 -1 -1 -2 -3 -4 -4 -5 -5 -3 -4 -4 -5 -7 -8 -7 -8 -8 -9 -10 -11 -10 -10 -11 -11 -12 -12 -13 -13 -13 -14 -14 -14 -12 -12 -12 -11 -11 -12 -10 -10 -10 -10 -10 -10 -9 -2 -1 0 0 1 2 2 3 4 6 7 9 10 11 13 14 15 16 17 18 18 20 20 22 21 19 19 18 17 17 17 15 15 15 14 14 14 11 10 10 8 8 8 6 7 6 7 7 7 6 5
 0 0 0 -1 -1 -1 -2 -2 -3 -4 -4 -4 -4 -4 -5 -7 -8 -8 -9 -8 -9 -10 -10 -11 -11 -11 -12 -12 -12 -12 -13 -13 -13 -14 -14 -14 -13 -12 -12 -12 -11 -12 -11 -11 -11 -11 -10 -10 -9 -2 -2 0 1 2 2 3 4 5 7 7 8 10 11 12 14 15 16 18 19 19 21 22 22 23 21 20 20 19 19 18 17 16 16 15 15 14 12 11 10 9 9 8 8 8 8 8 8 7 6 6
 0 0 0 -1 -1 -1 -1 -2 -3 -4 -4 -4 -5 -5 -6 -7 -8 -8 -10 -10 -10 -10 -11 -12 -12 -11 -12 -13 -13 -13 -13 -14 -14 -14 -14 -13 -14 -13 -14 -13 -13 -13 -12 -12 -11 -11 -10 -10 -9 -2 -1 0 1 2 2 3 4 5 7 7 8 11 11 13 15 15 16 18 19 19 22 21 22 24 21 21 20 21 20 19 18 17 16 16 15 15 12 12 11 10 9 9 8 8 9 8 8 7 7 7
 0 0 0 -1 -1 -1 -1 -1 -2 -1 -2 -1 -2 -4 -6 -6 -7 -8 -7 -8 -8 -9 -11 -11 -12 -11 -11 -12 -11 -11 -11 -11 -11 -11 -11 -12 -11 -10 -11 -11 -11 -11 -11 -10 -10 -9 -8 -7 -7 -2 0 0 1 2 3 4 4 5 5 6 6 7 9 11 12 14 16 17 18 19 19 21 21 22 23 21 21 21 20 19 19 17 17 16 15 15 15 13 12 12 12 12 11 10 9 8 7 8 8 6
 0 0 -1 -1 -1 -1 -2 -2 -2 -2 -2 -2 -4 -5 -6 -6 -7 -7 -7 -8 -9 -9 -10 -11 -11 -11 -10 -10 -11 -11 -11 -11 -11 -10 -10 -10 -10 -10 -10 -11 -11 -11 -11 -10 -9 -9 -8 -7 -7 -1 0 0 2 2 4 3 4 5 5 5 6 8 9 10 12 13 14 16 17 18 18 20 21 22 20 19 20 20 20 19 18 17 17 15 14 14 13 13 13 12 12 11 11 10 9 8 8 7 7 6
 0 0 -1 -1 -1 -1 -1 -2 -2 -3 -3 -4 -5 -5 -6 -6 -7 -7 -7 -8 -8 -9 -10 -10 -10 -10 -10 -10 -10 -10 -10 -11 -10 -9 -10 -10 -9 -9 -10 -11 -11 -11 -10 -10 -9 -9 -8 -7 -7 -1 0 0 2 2 3 3 3 4 5 5 4 7 9 9 11 12 14 15 16 17 18 19 20 21 20 19 20 19 18 18 16 16 15 14 14 12 12 13 13 12 12 11 10 10 9 8 8 7 7 6
 0 0 0 -1 0 0 -1 -2 -2 -3 -5 -5 -4 -5 -5 -6 -6 -6 -7 -7 -8 -8 -8 -9 -10 -10 -10 -10 -9 -9 -10 -9 -9 -9 -10 -9 -9 -9 -9 -10 -10 -11 -10 -9 -9 -9 -8 -8 -8 0 0 1 2 3 3 3 3 4 4 4 3 7 8 9 11 12 13 14 15 16 17 19 19 20 19 17 17 17 16 16 16 14 14 13 12 12 12 12 13 12 11 11 10 9 9 8 8 7 6 5
 0 0 0 0 0 0 -2 -2 -3 -4 -4 -5 -4 -5 -5 -6 -6 -6 -7 -8 -7 -7 -8 -8 -9 -10 -9 -9 -9 -9 -8 -8 -9 -9 -10 -10 -9 -9 -10 -10 -9 -10 -10 -9 -9 -9 -8 -8 -8 0 0 1 2 3 3 3 3 3 3 3 3 6 7 8 9 11 11 13 14 16 17 18 19 20 16 16 16 15 16 16 14 14 13 12 12 12 12 12 12 11 11 11 9 9 9 8 7 7 6 5
 0 0 0 -1 0 0 -1 -2 -3 -4 -5 -6 -5 -5 -5 -6 -5 -6 -7 -6 -6 -7 -7 -7 -9 -9 -10 -9 -9 -8 -8 -8 -8 -10 -9 -10 -9 -10 -11 -10 -10 -11 -9 -10 -9 -9 -8 -8 -8 0 0 0 1 2 2 2 3 3 3 2 2 5 6 7 8 10 10 12 13 15 16 17 19 19 15 15 15 14 15 16 14 13 13 12 12 12 11 11 11 10 11 10 8 9 8 8 7 7 6 5
 0 0 0 0 0 0 -1 -3 -5 -5 -6 -7 -4 -5 -4 -4 -5 -5 -6 -5 -6 -5 -6 -6 -9 -8 -9 -8 -8 -8 -8 -10 -9 -9 -8 -9 -9 -9 -9 -10 -10 -10 -10 -10 -10 -9 -9 -8 -9 0 0 0 1 1 1 2 0 0 0 0 0 3 5 5 6 7 7 11 12 13 13 15 16 17 14 14 14 14 14 14 14 13 12 12 11 11 10 10 10 10 9 9 9 8 9 7 8 6 5 6
 0 0 0 0 -1 -1 -3 -4 -4 -5 -5 -6 -5 -6 -5 -5 -5 -5 -5 -5 -5 -5 -6 -6 -8 -8 -8 -7 -8 -8 -10 -10 -10 -9 -8 -9 -8 -8 -9 -9 -10 -10 -9 -9 -9 -8 -8 -8 -8 0 0 0 0 0 1 0 0 0 0 0 0 2 4 4 4 5 7 10 11 12 13 15 17 17 13 13 13 13 13 13 12 12 12 11 12 11 10 10 10 9 9 9 8 7 7 7 7 6 6 5
 -1 0 -1 -1 -1 -1 -3 -4 -4 -6 -6 -6 -5 -5 -5 -5 -5 -6 -5 -5 -5 -5 -6 -6 -7 -7 -7 -8 -7 -8 -9 -10 -9 -9 -9 -9 -9 -9 -9 -8 -8 -8 -8 -9 -9 -8 -8 -8 -6 0 0 1 1 0 0 0 0 0 -1 0 0 1 3 3 3 4 6 10 11 11 12 13 15 16 12 13 13 12 12 12 11 11 11 10 11 12 11 10 10 8 9 9 7 7 8 7 6 6 6 5
 -1 -2 -2 -1 -3 -3 -4 -5 -5 -5 -6 -7 -6 -5 -5 -6 -6 -6 -5 -4 -4 -5 -5 -5 -6 -6 -6 -7 -8 -9 -9 -9 -9 -9 -9 -9 -9 -8 -8 -7 -6 -6 -8 -7 -8 -8 -7 -7 -8 0 0 0 0 0 0 0 -1 -2 -1 -2 -2 0 1 0 2 5 5 9 10 10 11 12 14 15 12 11 11 11 11 11 11 11 10 10 9 10 10 10 8 8 7 7 7 5 6 6 6 5 6 6
 -2 -3 -2 -3 -4 -4 -5 -5 -5 -6 -6 -6 -5 -5 -6 -6 -5 -6 -4 -4 -4 -5 -6 -6 -6 -6 -6 -7 -8 -8 -9 -9 -9 -9 -9 -9 -7 -7 -7 -5 -5 -5 -6 -6 -7 -7 -7 -7 -6 0 0 0 0 0 0 -2 -2 -2 -3 -3 -2 0 1 1 3 4 5 8 8 9 11 12 14 15 10 10 10 10 10 11 10 11 10 9 8 9 9 9 8 6 6 6 5 5 5 5 5 5 5 6
 -2 -3 -3 -3 -5 -4 -5 -6 -6 -7 -6 -7 -6 -6 -6 -6 -5 -5 -5 -4 -4 -5 -5 -5 -5 -5 -6 -7 -8 -9 -9 -9 -8 -9 -9 -8 -7 -7 -5 -5 -5 -4 -5 -5 -6 -6 -6 -6 -5 0 0 0 0 0 -1 -2 -2 -2 -3 -3 -3 -1 0 0 2 4 4 7 8 10 11 12 13 15 10 9 10 9 9 9 10 10 10 9 9 8 9 8 7 6 6 5 4 4 5 5 4 5 5 6
 -3 -3 -3 -3 -4 -4 -5 -5 -5 -5 -6 -6 -6 -6 -5 -6 -5 -6 -6 -5 -6 -6 -4 -4 -4 -5 -5 -5 -4 -5 -5 -6 -5 -6 -7 -7 -7 -7 -6 -6 -6 -7 -7 -5 -6 -5 -5 -5 -4 0 -1 -1 -2 -2 -3 -2 -2 -3 -3 -3 -3 -2 0 0 1 2 3 5 7 7 8 10 10 12 8 8 8 8 8 8 9 8 9 9 9 8 8 8 7 7 7 8 8 8 7 7 7 7 7 7
 -3 -2 -2 -3 -3 -4 -5 -5 -5 -5 -5 -6 -6 -5 -5 -4 -4 -5 -4 -4 -4 -4 -4 -4 -4 -5 -5 -4 -4 -4 -5 -5 -5 -5 -6 -7 -5 -5 -5 -5 -5 -5 -5 -5 -5 -4 -5 -5 -5 -1 -2 -2 -3 -3 -3 -2 -3 -2 -2 -2 -2 0 0 0 1 2 3 5 7 7 8 9 10 11 7 8 8 7 8 8 7 8 7 7 8 7 7 7 7 6 6 7 8 8 8 7 8 7 7 8
 -2 -2 -2 -3 -4 -5 -5 -5 -5 -5 -5 -4 -5 -5 -5 -4 -3 -4 -4 -4 -4 -4 -4 -4 -4 -5 -5 -4 -5 -4 -4 -4 -4 -4 -6 -7 -3 -4 -3 -3 -3 -4 -4 -4 -4 -3 -5 -4 -4 -1 -1 -2 -2 -3 -2 -1 -2 -3 -2 -2 -3 -1 0 0 1 2 3 5 6 7 7 8 9 11 7 7 7 7 7 7 6 7 6 6 7 7 6 6 5 6 6 7 7 7 7 7 7 8 7 8
 -3 -3 -3 -4 -6 -6 -5 -5 -5 -4 -4 -4 -5 -4 -4 -3 -2 -2 -3 -3 -4 -3 -4 -4 -4 -4 -5 -4 -4 -4 -4 -3 -2 -4 -4 -5 -2 -2 -2 -2 -2 -2 -3 -3 -4 -2 -2 -2 -3 0 -2 -2 -3 -1 -1 -2 -2 -2 -2 -3 -2 -1 -1 0 1 2 3 4 5 5 6 7 8 9 6 5 6 6 6 6 6 5 5 5 5 5 6 5 5 5 5 6 7 7 7 7 8 9 9 9
 -3 -4 -3 -5 -5 -7 -6 -5 -5 -4 -4 -3 -4 -3 -3 -2 -1 -1 -2 -4 -3 -3 -4 -4 -3 -3 -3 -4 -4 -3 -3 -3 -2 -3 -3 -3 -1 -1 -1 -1 -1 -2 -2 -2 -2 -2 -1 -1 -2 -1 -2 -2 -1 -1 -1 -1 -2 -2 -2 -3 -3 -1 -1 0 2 2 3 4 5 6 6 7 8 9 5 5 5 5 5 6 5 4 5 4 4 5 5 5 5 5 5 5 7 7 7 7 8 9 9 9
 -3 -4 -3 -5 -6 -7 -6 -5 -5 -4 -4 -4 -4 -3 -3 -2 -1 -1 -1 -2 -3 -3 -3 -5 -3 -2 -3 -3 -3 -3 -3 -2 -2 -2 -2 -3 -1 0 0 0 0 0 -1 -1 -1 -1 -1 -1 -1 -2 -2 -2 -2 -1 0 0 -1 -1 -2 -2 -3 -1 -1 0 1 2 2 3 5 6 6 8 8 9 4 4 4 4 5 5 4 4 5 4 4 5 4 5 5 5 5 6 6 7 8 8 8 9 10 10
 -3 -4 -5 -6 -8 -8 -7 -5 -5 -4 -3 -3 -4 -2 -1 -1 0 0 0 -1 -1 -2 -3 -3 -2 -3 -3 -4 -3 -4 -2 -2 -2 -1 -1 -1 0 0 0 0 0 0 0 0 0 0 0 -1 -1 -1 -1 -1 -2 -1 0 -1 -2 -2 -2 -2 -2 -2 -1 0 0 1 1 3 5 5 5 7 7 8 3 3 3 3 3 4 4 4 4 4 3 3 4 4 5 5 5 6 6 6 7 7 8 8 10 10
 -4 -4 -5 -6 -7 -7 -5 -4 -4 -3 -3 -3 -1 -1 -1 0 0 0 0 0 -1 -2 -3 -3 -2 -3 -3 -3 -2 -2 -1 -1 -1 0 0 0 0 0 1 0 0 0 1 0 0 0 0 -1 -1 -1 -1 -2 -1 -1 -1 -1 -2 -2 -1 -2 -2 -1 -1 0 0 1 1 4 4 5 4 5 6 7 2 2 2 3 2 3 3 4 3 3 3 3 4 4 4 5 6 5 6 6 6 7 7 8 9 10
 -4 -5 -4 -6 -7 -7 -6 -5 -5 -3 -3 -1 -1 -1 0 0 0 0 0 0 0 -1 -2 -1 -2 -3 -3 -2 -2 -1 0 0 0 0 0 0 0 0 1 1 0 0 1 0 0 0 0 0 -1 -1 -1 -2 -1 -1 -2 0 -1 -1 -1 -1 -1 0 0 -1 0 1 1 3 4 4 4 5 6 7 2 2 2 3 2 4 4 3 3 3 3 3 3 3 3 5 6 6 7 6 6 7 7 8 9 11
 -4 -5 -5 -5 -6 -6 -5 -5 -5 -2 -1 -1 0 0 0 0 0 1 -1 -1 -1 -1 -1 -1 -2 -2 -2 -1 -1 0 0 0 0 0 0 0 1 0 0 0 0 0 1 1 1 1 0 0 -1 -1 -1 -2 -2 -2 -2 0 0 0 -1 -1 -1 0 0 -1 0 0 1 3 3 3 4 4 5 5 2 2 1 3 4 4 3 2 3 3 2 2 3 4 4 5 6 6 6 6 6 6 8 9 10 11
 -4 -5 -4 -4 -5 -6 -5 -4 -4 -2 -1 0 0 0 0 0 0 1 0 -1 0 0 -1 -1 -2 -2 0 -1 0 0 0 0 0 1 1 1 1 1 1 0 0 0 0 1 0 0 0 -1 -1 -1 -2 -1 -3 -2 -2 0 0 0 0 0 0 0 0 0 1 1 0 1 3 3 3 4 3 4 2 2 1 2 3 3 3 2 2 3 2 2 3 4 5 6 6 7 7 7 7 7 8 9 9 10
 -4 -4 -4 -4 -4 -4 -4 -4 -4 -1 0 0 0 0 0 0 0 1 0 0 0 0 0 0 -1 -1 0 0 0 0 1 1 1 1 1 1 3 3 2 1 1 0 0 0 0 0 -1 -1 -1 -2 -2 -2 -2 -3 -2 0 0 0 0 0 0 0 0 0 1 2 1 2 3 2 2 2 2 3 2 2 2 2 2 2 2 1 2 2 2 2 3 4 4 6 6 7 8 8 7 7 8 9 9 10
 -5 -4 -4 -4 -4 -4 -3 -3 -2 -1 0 0 0 0 0 0 0 1 0 0 0 0 0 0 0 0 0 0 0 0 1 1 2 2 2 2 3 3 2 2 1 0 0 0 0 0 0 -1 -1 -2 -2 -2 -2 -2 -2 0 0 0 0 0 0 0 1 1 2 1 1 1 2 2 1 1 1 2 1 1 2 2 1 2 1 1 2 2 2 3 3 4 4 6 6 6 7 7 8 7 9 9 9 10
 -5 -4 -4 -5 -4 -5 -5 -2 -3 -3 -3 -2 -3 -3 -3 -2 -2 -2 -2 -2 -1 -1 -1 -3 -2 -2 -1 -2 -1 -1 -1 0 0 0 0 0 -1 0 0 0 0 -1 -1 -1 -1 -1 -1 0 -1 -2 -1 0 0 0 0 0 1 2 3 4 4 5 5 4 5 4 3 3 3 3 4 4 3 4 4 5 5 5 6 5 6 5 6 6 6 6 6 6 6 6 5 6 5 6 6 7 7 7 9 9
 -4 -3 -3 -3 -3 -3 -2 -1 -2 -1 -2 -2 -2 -2 -2 -1 -1 -1 -1 -1 -1 0 0 -1 -1 -1 -1 0 -1 -1 0 0 0 0 0 0 0 0 0 0 0 0 -1 -1 0 0 -1 0 -1 -2 -2 -1 -1 -1 0 1 1 2 3 4 4 4 5 4 3 3 3 2 2 3 4 4 3 4 5 5 5 6 6 6 5 5 6 7 6 6 6 7 6 6 5 5 5 5 6 6 7 7 8 9
 -3 -3 -3 -3 -2 -2 -2 -1 -2 -1 -1 -1 -1 -1 -1 -1 0 0 0 -1 -1 0 0 0 0 0 0 0 0 0 0 0 0 0 0 0 0 0 0 0 0 0 -2 -1 0 0 0 0 0 -2 -2 -2 0 0 0 1 1 2 3 3 3 3 4 4 3 2 2 3 3 3 4 4 4 5 5 5 5 6 6 4 5 6 6 7 6 6 6 6 6 6 6 6 4 5 6 6 6 7 8 8
 -3 -2 -2 -2 -2 -2 -1 0 0 0 0 0 -1 0 0 0 0 0 0 0 0 0 0 0 0 1 1 0 1 0 0 1 1 1 0 0 0 0 0 0 -1 -1 -2 -1 -1 0 0 0 0 -3 -2 -2 -1 0 0 1 2 2 3 3 3 3 3 3 3 2 2 2 3 4 4 5 5 7 5 5 5 5 5 5 6 6 6 7 5 5 6 7 7 6 6 6 5 5 5 5 6 7 7 7
 -3 -2 -2 -2 -1 -1 0 0 0 0 0 0 0 0 0 0 0 0 1 1 1 1 0 1 1 2 1 1 2 1 1 1 1 0 0 0 1 1 1 0 -1 -2 -2 -2 -1 0 0 0 -1 -3 -3 -2 0 0 0 1 2 2 3 3 3 3 2 2 2 2 2 2 3 3 4 5 5 6 6 6 5 5 5 5 5 5 6 5 5 5 7 7 7 6 6 5 5 5 5 5 6 7 6 6
 -3 -2 -2 -2 -1 -1 0 0 0 0 1 0 1 0 0 0 1 0 1 1 2 2 2 2 2 2 1 2 1 1 2 1 2 1 0 1 2 1 0 0 -1 -2 -1 -2 -1 0 0 0 0 -4 -3 -2 0 0 0 1 1 1 2 2 1 3 2 2 2 1 1 1 2 3 4 4 6 6 5 6 5 5 5 5 5 5 6 5 5 5 7 7 7 6 6 6 5 5 5 6 5 6 5 5
 -3 -2 -1 0 0 0 0 0 0 0 1 1 1 2 3 2 3 2 2 3 3 3 4 4 2 3 2 2 2 2 2 2 2 3 3 3 2 2 2 1 0 0 -2 -1 -1 0 0 0 0 -4 -4 -2 -1 0 1 1 1 1 1 1 1 3 2 1 1 1 1 1 4 4 6 6 7 7 6 7 6 5 5 5 5 6 6 6 5 6 7 6 6 6 5 5 4 4 4 3 4 4 4 5
 -3 -2 -1 0 0 0 0 0 0 1 1 1 3 3 3 4 4 3 4 4 4 5 4 4 4 4 3 3 3 3 3 3 3 4 4 4 3 2 2 1 0 0 0 0 0 0 0 0 0 -4 -4 -3 -1 0 0 0 1 1 0 0 0 2 2 2 1 1 1 3 4 5 6 7 7 8 7 8 6 5 5 5 6 7 6 6 6 6 7 7 7 5 4 4 4 4 3 3 4 4 4 4
 -2 -2 -1 0 0 0 0 0 0 1 2 1 3 4 3 4 4 4 4 4 5 5 5 4 4 4 3 4 3 5 4 5 5 4 4 4 3 3 3 2 1 0 0 0 0 0 0 0 0 -4 -4 -2 -2 -1 -1 0 0 0 0 0 0 1 1 1 2 2 1 3 4 5 7 7 8 9 7 7 6 6 6 6 6 6 7 7 6 7 7 7 8 7 4 5 3 3 2 2 3 3 3 5
 -2 -2 -1 0 0 1 0 0 1 2 3 4 4 5 5 5 5 5 5 6 5 6 7 7 5 4 4 4 6 5 6 6 6 6 6 6 4 5 4 2 1 0 0 0 0 0 0 -1 0 -4 -4 -4 -3 -2 -2 -1 0 0 0 0 0 1 1 1 2 3 3 4 5 6 8 10 10 10 8 7 7 7 8 8 7 7 8 7 7 7 8 7 7 6 5 5 3 3 1 1 1 3 4 4
 -2 -1 -1 0 1 1 0 0 1 3 4 4 5 6 6 5 6 6 6 6 7 8 8 7 5 5 5 7 7 7 7 7 6 7 7 6 5 5 5 2 1 1 0 0 0 0 0 -1 -1 -5 -5 -4 -3 -2 -2 -1 0 0 0 0 0 1 1 2 3 3 3 4 5 7 8 9 11 11 9 8 8 8 9 8 8 8 8 8 7 7 7 6 6 5 5 5 3 3 2 1 3 4 4 3
 -2 -1 -1 0 1 1 1 1 2 3 4 4 6 6 6 6 6 7 7 7 8 8 8 8 6 6 6 7 7 7 8 7 7 7 7 6 6 6 5 3 2 1 0 0 0 -1 -1 -1 -1 -5 -5 -6 -3 -3 -4 -3 -2 -1 -2 -1 -1 1 1 2 3 3 4 5 6 7 9 10 11 11 9 9 9 9 9 9 8 8 8 8 8 8 6 6 7 5 4 4 3 3 3 2 3 3 3 3
 -1 0 0 0 0 0 0 3 3 4 5 6 6 7 6 6 6 7 7 8 8 7 7 7 7 8 8 8 8 7 7 8 8 8 8 8 6 5 5 4 2 2 1 0 0 0 0 0 -1 -6 -6 -6 -5 -4 -3 -3 -1 -1 0 0 0 0 2 2 4 5 5 7 8 9 9 10 12 13 10 10 10 10 10 9 10 9 8 8 8 7 7 6 6 6 6 5 5 4 3 3 3 2 2 2
 0 1 1 0 0 0 3 3 3 5 6 6 6 7 7 6 6 7 7 8 8 7 7 8 8 8 8 8 8 8 7 8 8 8 8 7 6 5 5 3 2 1 0 0 0 -1 -1 0 -1 -5 -5 -5 -3 -3 -3 -1 0 0 0 0 0 2 3 3 5 5 6 7 8 9 9 10 12 12 11 10 10 11 11 11 9 9 8 8 8 8 6 5 6 6 6 5 5 4 4 3 3 2 2 2
 0 1 1 2 1 2 2 4 3 5 5 5 6 6 6 7 6 7 7 8 8 8 8 8 7 8 8 9 8 8 7 8 9 9 8 9 6 5 4 3 2 1 0 0 0 -1 -1 0 -1 -5 -5 -4 -2 -2 -1 0 0 0 1 1 1 2 3 4 5 5 5 8 8 9 10 11 12 13 11 11 11 11 11 12 9 9 9 8 8 7 6 5 5 5 5 3 4 3 3 3 3 2 2 2
 0 2 2 2 2 3 3 4 4 5 6 6 5 5 5 5 6 7 8 8 8 9 9 10 9 9 8 9 9 8 7 9 8 9 9 9 6 5 4 2 0 0 0 -1 -1 -1 -1 -1 -1 -5 -3 -3 -1 0 0 0 1 2 2 3 3 3 5 5 5 5 5 7 9 9 10 12 12 13 12 12 12 12 13 12 9 9 9 8 8 7 6 5 5 5 4 4 4 3 3 2 2 1 1 1
 2 2 3 3 3 3 4 5 4 6 7 7 5 4 4 5 5 6 8 9 9 9 9 10 9 9 9 9 9 9 9 9 9 9 8 8 6 5 4 1 0 0 0 -1 -1 0 -1 -2 0 -4 -3 -2 0 0 0 1 1 2 3 4 4 4 4 4 5 4 5 8 9 10 10 11 12 13 12 12 12 13 13 13 10 10 9 8 8 8 5 5 5 5 4 4 3 3 2 1 1 1 1 1
 2 3 3 4 4 4 4 5 6 7 7 7 5 4 4 5 6 7 8 9 9 10 10 11 10 10 10 9 9 9 8 9 9 9 9 9 7 5 4 2 0 0 -1 -1 -1 0 0 0 0 -3 -3 -2 0 0 1 2 2 2 3 4 4 5 4 5 5 4 5 7 9 9 10 11 11 13 13 13 14 13 13 12 11 11 11 10 8 8 7 6 5 5 4 3 2 2 1 1 0 0 1 0
 2 3 4 3 4 4 5 6 7 7 8 7 4 6 7 8 8 8 9 10 11 12 13 13 10 10 10 9 9 9 9 10 10 9 9 8 7 5 4 2 0 0 -1 0 0 0 0 0 0 -3 -1 -1 0 1 1 3 4 5 5 5 6 5 6 6 6 6 6 7 9 11 12 12 12 13 14 13 13 13 13 12 12 10 10 10 8 7 6 5 5 5 3 2 1 1 0 0 0 0 0 0
 3 4 4 5 4 5 7 7 8 9 9 8 6 7 8 9 9 9 10 11 12 13 14 13 11 11 10 10 10 9 10 11 10 9 8 8 6 4 3 1 0 0 0 0 0 -1 -1 0 0 -2 -1 0 1 1 2 4 4 6 6 5 6 7 8 8 8 7 8 9 10 11 12 12 12 13 14 13 13 13 13 12 11 10 10 9 8 7 6 5 5 4 3 2 1 0 0 0 0 0 0 0
 4 4 4 5 5 5 7 8 8 9 9 8 7 7 8 9 9 9 11 12 13 14 14 13 11 12 10 10 10 9 11 11 11 10 9 9 6 5 3 0 0 0 0 0 0 -1 -1 0 0 -2 -1 0 1 1 2 5 5 5 7 6 7 8 9 9 9 9 9 10 11 11 12 13 13 13 15 13 14 12 12 11 11 11 10 10 8 8 7 6 5 6 4 3 0 0 0 0 0 0 0 0
 4 4 5 6 6 6 8 9 10 9 9 9 8 8 9 10 9 9 12 14 15 15 14 14 13 12 11 9 9 9 11 11 11 10 10 10 5 4 3 1 1 0 0 0 0 -1 0 0 0 -2 -1 0 1 2 2 6 6 7 7 7 7 9 9 10 10 10 10 11 12 12 12 13 13 14 14 14 13 12 12 12 11 11 11 9 8 7 6 6 6 5 4 3 0 0 0 0 0 0 0 0
 3 4 4 5 6 6 8 9 9 9 9 10 9 9 10 10 10 11 13 13 14 14 14 14 14 13 12 10 10 9 12 11 12 10 10 9 6 5 4 2 1 1 1 0 0 0 0 0 0 -2 -1 0 1 2 2 5 6 7 8 7 8 9 10 11 10 10 11 12 12 13 13 13 13 14 13 13 13 12 12 12 11 11 10 8 8 7 6 6 5 4 3 3 2 1 0 0 0 0 0 0
 3 4 4 6 6 6 8 8 8 9 10 9 10 10 10 11 10 11 12 13 14 14 14 14 14 14 13 11 11 10 11 11 11 9 9 8 6 6 4 2 1 1 1 0 0 1 0 0 0 -2 -2 -1 1 2 2 5 6 7 8 8 8 11 11 11 10 10 12 12 12 13 13 13 13 14 13 13 13 12 12 12 11 11 10 7 7 6 6 6 6 3 3 3 2 2 1 1 1 1 0 0
 3 3 4 5 6 5 7 8 9 9 9 9 10 10 10 11 11 11 13 13 14 15 14 15 14 14 14 13 12 12 11 12 11 9 9 9 7 6 5 4 3 3 2 1 1 1 0 0 0 -2 -1 -1 0 1 2 5 6 7 8 9 10 11 11 11 12 12 12 13 13 14 13 14 14 14 14 13 13 13 13 12 11 10 10 7 7 6 6 5 5 4 3 3 2 2 2 1 0 0 0 0
 2 3 3 3 4 4 4 5 5 6 7 7 8 8 9 10 11 11 11 12 13 13 14 14 15 13 12 12 10 9 9 7 7 7 5 4 3 3 4 3 2 2 2 1 1 1 0 0 0 -2 0 1 2 3 4 5 6 7 7 8 9 10 10 9 9 9 10 10 11 11 12 12 13 13 14 14 14 14 13 12 12 11 11 10 10 9 9 8 8 7 6 5 4 4 3 3 2 1 0 0
 2 3 3 3 4 4 4 4 5 6 7 7 7 7 9 11 11 11 12 13 12 13 13 14 13 13 12 10 9 9 8 7 6 5 5 4 4 4 4 3 2 2 1 1 1 1 1 0 0 0 0 1 1 2 3 5 6 6 7 8 9 10 10 9 9 9 10 10 11 11 12 12 13 13 14 14 14 13 13 13 12 11 11 10 10 9 9 8 8 6 6 5 4 4 3 2 2 1 0 0
 1 2 2 3 3 3 4 4 5 6 6 7 7 8 9 10 11 11 11 12 12 13 13 14 12 12 12 10 9 9 8 7 6 5 4 3 5 4 3 3 2 1 2 1 1 1 0 0 0 0 0 0 2 2 3 5 6 7 8 8 8 10 10 9 9 9 9 10 11 11 12 11 13 13 14 14 14 14 13 13 12 11 10 9 9 9 9 8 7 7 6 5 4 3 3 2 1 1 0 -1
 0 1 1 2 3 3 4 4 4 5 6 6 7 8 9 10 10 10 11 11 11 12 13 14 11 10 11 10 9 8 8 7 6 5 3 3 4 4 4 3 2 1 1 1 1 0 0 0 0 0 0 0 2 3 3 5 6 6 8 9 9 10 9 9 10 10 10 9 10 11 11 11 11 12 13 14 13 13 14 13 12 11 10 9 9 9 9 8 7 7 6 5 5 3 2 1 0 0 -1 -1
 0 1 1 2 3 3 4 4 4 5 6 6 6 7 8 9 9 10 11 12 11 12 12 13 10 10 10 9 9 9 7 6 6 4 3 3 5 4 4 3 2 2 1 2 1 0 1 0 0 0 0 0 1 2 3 4 5 6 8 8 8 9 9 9 10 10 10 9 9 10 11 10 11 11 14 15 14 13 14 13 11 11 10 10 9 9 8 8 7 6 6 5 4 3 2 1 0 0 0 -1
 0 0 1 2 3 2 4 4 4 5 5 6 5 6 8 8 9 10 10 11 11 12 12 13 10 10 10 9 8 8 7 6 6 4 4 3 6 5 4 3 2 2 1 2 1 0 0 0 0 -1 0 0 1 2 2 4 5 6 6 7 7 9 9 9 9 9 10 8 9 9 10 10 10 11 14 14 13 13 13 12 11 11 11 10 10 9 9 8 8 6 6 5 4 3 2 1 0 0 -1 -1
 0 0 0 1 1 1 4 4 5 6 6 6 5 6 7 7 8 9 10 10 11 12 11 11 10 8 8 8 7 7 7 7 8 6 5 4 6 5 4 4 2 1 1 2 2 1 2 1 1 -1 -1 0 0 1 2 4 5 5 5 5 6 9 8 8 7 7 7 9 9 10 11 11 11 11 13 12 12 13 12 12 11 10 10 10 9 9 9 8 7 7 6 6 4 2 1 1 0 0 0 -1
 0 0 1 0 1 1 3 3 4 6 7 7 6 6 7 8 8 9 10 10 10 10 10 11 8 8 8 7 7 7 7 8 8 6 6 5 5 4 4 3 3 2 2 2 2 2 1 0 0 -1 -1 0 1 2 2 4 5 5 5 5 5 8 8 8 7 6 7 9 10 11 11 11 11 11 12 12 12 11 12 11 10 10 10 9 9 9 9 8 8 7 7 6 3 3 2 1 0 0 0 0
 0 0 0 1 1 2 3 4 5 6 7 6 6 6 7 7 8 8 10 9 9 10 10 10 7 8 7 7 7 7 7 8 8 6 6 4 5 4 4 4 3 1 1 2 2 1 1 1 1 0 0 0 1 2 2 3 4 5 5 5 5 8 8 8 7 7 8 9 10 10 11 12 11 10 11 12 12 12 11 11 10 10 10 9 9 9 9 9 8 7 7 5 2 2 1 1 0 0 0 0
 0 0 0 1 1 2 3 4 5 6 6 7 6 7 7 7 7 7 9 9 9 9 10 10 7 7 7 7 6 6 7 8 8 6 4 4 4 4 4 4 3 2 2 2 2 2 2 2 1 0 0 0 1 2 2 3 4 4 4 5 5 7 7 7 8 7 7 9 11 11 10 10 11 10 11 10 10 11 11 10 10 10 10 9 10 10 9 9 9 7 6 5 3 3 2 2 2 1 1 0
 -1 0 0 1 1 1 3 4 5 5 6 7 6 6 6 7 7 6 8 7 8 9 10 9 5 5 6 6 6 6 6 7 7 5 4 4 4 3 4 4 3 3 2 2 2 2 2 2 2 0 0 0 2 2 2 4 4 4 4 5 5 7 7 8 7 7 8 10 10 11 10 10 10 10 10 9 10 11 11 10 9 10 10 10 10 10 9 9 8 7 6 6 3 3 3 2 2 2 1 1
 -1 -1 0 0 0 1 2 3 5 5 6 7 6 6 6 6 6 7 7 7 8 8 8 8 5 5 5 5 6 6 6 6 6 4 4 4 4 4 3 3 3 3 3 3 3 3 2 2 2 0 1 1 2 2 2 4 3 4 4 5 6 6 7 7 8 8 7 9 9 10 9 10 10 9 9 9 9 10 10 10 10 10 10 10 10 10 10 9 9 7 6 6 4 3 2 3 3 1 1 1
 -1 0 0 0 1 2 2 3 3 5 5 6 6 5 6 6 5 5 6 6 7 7 7 7 5 4 4 4 3 3 2 2 4 3 2 3 4 3 3 2 2 1 1 2 2 2 2 1 2 1 1 2 2 2 2 2 3 3 3 4 5 6 6 6 6 6 6 7 8 8 8 7 8 9 9 9 9 9 8 9 9 8 9 9 9 9 10 8 8 8 6 6 5 4 3 3 3 3 2 1
 0 0 0 1 2 2 2 2 3 4 4 5 4 4 5 4 4 5 5 5 6 6 6 6 4 4 4 3 2 2 1 1 2 2 2 2 3 3 2 2 2 2 1 1 1 2 2 1 1 1 1 1 2 1 1 2 3 2 3 4 4 6 6 6 6 6 6 7 7 8 7 8 8 8 8 8 8 7 7 7 7 8 9 8 8 9 9 8 7 5 5 4 3 4 3 2 3 3 2 1
 0 0 1 0 1 1 1 2 3 3 3 4 4 3 4 4 4 6 5 5 6 5 6 5 3 4 4 2 2 2 1 1 1 1 2 2 1 2 2 1 2 2 1 1 2 2 1 1 0 1 1 1 1 1 1 2 3 3 4 4 5 6 5 6 6 6 7 6 7 7 7 7 7 7 7 7 7 7 6 7 7 8 8 7 8 8 8 7 6 5 5 4 3 3 3 3 3 3 2 1
 0 0 0 0 1 1 1 2 2 2 2 2 2 2 2 4 3 4 4 3 3 5 4 4 3 3 2 2 1 1 1 0 0 1 1 1 1 1 1 1 2 2 1 1 1 1 1 0 0 1 1 1 1 3 3 2 3 4 4 5 5 6 6 6 6 6 6 6 6 5 6 6 6 7 7 6 5 6 5 5 6 6 6 7 7 7 8 6 5 4 3 3 2 2 2 2 2 2 1 1
 0 0 0 0 1 1 1 2 1 1 1 1 0 1 1 2 2 3 3 1 2 3 4 4 3 2 2 1 0 0 0 0 0 0 0 0 1 1 1 1 2 2 1 1 1 0 0 0 0 1 1 2 4 5 3 3 3 3 4 5 5 6 7 6 5 5 6 5 5 5 5 6 6 6 5 5 5 5 6 6 5 5 6 6 6 6 6 5 4 2 2 2 1 2 2 2 2 2 2 1
 0 0 0 0 0 0 0 1 0 0 0 1 0 0 1 2 3 3 2 2 2 2 3 2 2 2 2 0 0 0 0 -1 0 0 0 0 0 0 0 1 1 2 0 1 0 0 0 0 0 2 2 1 3 4 3 2 3 3 3 4 5 6 6 6 6 5 6 5 5 4 5 6 6 6 4 4 4 4 5 4 4 4 5 5 5 6 5 5 4 3 1 2 1 1 1 2 1 1 0 1
 -1 -1 -1 -1 -1 -1 0 0 0 0 0 0 -1 0 0 0 1 2 2 2 1 1 1 2 2 1 1 1 0 0 0 -1 -1 -1 0 -1 0 0 0 0 0 0 1 1 1 1 0 0 -1 2 2 2 3 2 3 2 3 3 3 4 5 6 5 6 5 5 5 5 5 5 4 5 5 5 3 3 3 3 3 3 3 3 4 4 4 4 5 3 2 2 1 0 0 1 1 1 0 0 1 1
 -1 -1 -1 -2 -2 -2 0 0 0 0 0 0 -1 0 0 0 0 1 1 1 1 0 0 1 1 1 0 0 0 0 -1 -1 0 -1 -1 -1 0 0 0 0 0 0 1 1 1 1 0 0 -1 2 2 2 2 1 2 3 3 3 4 4 5 5 5 5 4 4 4 4 3 4 3 4 4 6 3 3 3 3 3 3 2 3 4 4 3 4 3 2 2 1 1 1 1 2 1 1 1 0 1 1
 0 -1 0 -3 -2 -1 -1 0 0 0 0 0 -1 0 0 0 0 0 0 0 0 0 0 1 0 1 0 0 0 0 -1 -1 -2 -1 -1 -1 -1 -1 0 0 0 0 1 1 1 2 1 0 0 1 2 1 1 2 1 2 2 2 3 4 5 5 5 5 4 4 4 3 3 2 2 3 4 4 3 2 2 2 2 2 1 2 3 4 3 2 3 2 2 1 1 2 1 1 1 1 1 1 1 1
 0 0 -1 -1 -1 -1 0 0 0 0 0 -1 -1 -1 0 0 0 0 0 0 0 0 0 0 0 0 0 -1 -1 -1 -1 -2 -2 -1 -1 -1 -1 -1 -1 0 0 0 1 2 2 2 1 0 0 1 1 1 1 1 1 2 2 2 3 4 4 4 4 3 4 4 4 3 2 2 1 2 3 4 2 2 1 1 1 1 1 2 3 3 2 2 2 2 1 1 1 1 1 2 1 1 1 1 1 1
 0 0 -2 -1 -1 0 -2 -1 0 -2 -1 -2 -2 -2 -2 0 0 0 -1 0 -1 0 0 0 0 0 0 -1 -2 -1 -2 -2 -1 -1 -2 -1 -1 -1 -1 0 0 0 1 1 2 1 1 0 0 1 0 1 1 1 1 2 1 2 3 3 4 5 4 3 4 4 4 3 3 3 1 2 2 4 1 1 1 0 0 0 0 1 2 2 0 0 1 1 0 1 2 1 1 1 1 2 2 1 1 1
 0 -1 -1 -1 -1 -2 -2 -2 -1 -2 -3 -2 -2 -3 -3 -1 -1 -1 -1 0 0 0 0 0 0 0 0 -2 -2 -2 -2 -2 -2 -2 -2 -2 -2 -2 -1 0 0 0 0 0 1 0 0 0 0 0 1 0 1 1 1 1 1 2 2 3 3 4 4 4 4 3 3 3 3 3 2 2 2 3 0 0 0 0 0 0 0 0 0 0 0 0 1 0 0 1 2 2 1 1 1 2 2 1 1 0
 0 0 0 -1 -2 -3 -2 -3 -2 -4 -3 -4 -3 -3 -4 -3 -2 -3 -2 -1 0 0 0 0 0 0 -1 -2 -2 -2 -2 -2 -1 -2 -3 -2 -3 -2 -1 0 0 0 0 0 0 0 0 0 0 1 0 1 1 1 0 2 1 1 3 2 3 3 3 3 3 4 3 3 3 2 2 2 2 2 0 0 0 0 0 0 0 0 0 0 0 0 0 0 0 1 1 1 1 1 2 1 1 0 0 0
 0 0 0 -1 -2 -2 -3 -3 -4 -4 -4 -4 -4 -4 -4 -3 -4 -3 -3 -2 -2 -1 0 0 0 0 -1 -2 -2 -2 -2 -2 -2 -2 -2 -3 -2 -2 -1 0 0 0 0 0 -1 0 0 0 0 0 0 1 1 1 1 1 1 1 2 2 3 3 2 3 3 3 3 3 3 2 2 2 2 1 0 0 0 0 -1 -1 -1 -1 -1 0 0 0 0 0 0 0 1 2 2 2 2 1 1 0 0 0
