 0 -1 -3 0 -1 0 -1 -2 -5 -6 -7 -9 -9 -10 -6 -4 0 0 1 2 2 3 1 2 0 0 2 3 0 -1 0 3 6 6 9 7 7 5 4 4 1 1 1 4 3 4 7 9 5 5 11 11 12 16 19 18 22 27 27 34 35 35 38 39 43 47 48 49 51 50 52 52 53 54 54 49 45 45 42 41 40 36 32 31 28 26 23 23 20 19 19 18 14 17 12 15 11 9 7 0
 0 -3 -1 0 -2 -2 -2 -1 -3 -5 -6 -7 -11 -12 -8 0 3 3 4 4 7 5 1 2 0 0 0 0 -2 -1 1 5 6 8 10 9 9 7 7 2 1 2 3 3 4 5 6 8 6 11 14 14 15 17 17 22 23 26 34 38 37 39 40 42 48 50 51 51 55 53 54 55 55 54 52 50 48 45 43 43 37 34 31 31 30 28 26 24 23 22 22 19 17 19 17 17 13 10 5 0
 0 1 -1 0 0 0 -4 -3 -1 -5 -4 -6 -4 -8 -7 1 2 4 6 7 11 9 6 4 1 0 0 0 -2 -1 -2 4 7 10 10 8 8 7 7 1 2 3 6 4 4 5 8 6 5 12 15 17 18 20 20 26 25 27 35 37 40 39 44 46 48 52 52 54 56 58 57 58 58 54 50 50 47 47 45 42 38 35 34 30 31 29 29 27 26 24 26 19 22 21 18 17 15 13 4 2
 3 5 1 0 -1 -2 -3 -2 0 -2 -4 -8 -4 -2 -1 0 4 7 9 11 14 11 8 6 1 1 -1 -1 -3 0 0 4 11 10 9 7 9 5 4 2 0 2 2 4 1 4 4 4 3 13 16 18 18 22 22 24 25 32 36 41 43 43 48 50 52 54 54 55 58 61 60 62 59 60 50 52 49 47 44 47 39 37 35 33 32 30 29 32 30 26 24 26 20 22 21 18 15 11 9 2
 7 7 6 2 0 0 -2 -1 0 -2 -4 -4 -5 -3 -1 1 2 6 10 8 11 10 9 5 3 4 2 -2 -4 -3 0 1 6 8 8 9 9 6 4 1 0 0 1 2 3 5 5 4 4 17 16 17 21 23 23 24 24 29 41 44 46 48 50 50 52 54 54 57 61 61 62 59 59 60 52 50 50 48 47 43 39 39 36 36 33 33 35 37 34 29 27 25 22 22 19 17 16 11 7 1
 8 10 9 8 2 2 -2 0 0 -1 -3 -7 -3 -3 2 4 5 8 12 11 10 11 6 8 2 4 3 0 -2 0 -1 0 4 7 8 7 11 8 5 1 0 1 1 2 2 5 4 5 2 17 16 19 20 22 24 26 29 33 43 45 48 50 53 51 55 53 53 58 61 60 61 60 62 62 51 50 52 48 47 45 43 41 41 39 37 34 37 36 35 31 29 27 22 21 16 14 11 9 7 1
 14 10 11 5 2 0 -1 0 -1 -3 -4 -6 -4 0 0 4 8 10 16 15 17 12 8 8 3 1 0 -1 -1 -1 -1 3 4 6 8 12 10 7 5 5 3 0 2 4 5 4 4 5 1 19 25 27 24 27 27 29 39 40 44 49 51 53 52 54 53 53 53 56 59 59 65 65 65 66 51 49 48 48 48 48 45 43 41 41 40 40 37 40 38 35 29 27 23 17 14 13 11 8 5 2
 13 10 9 5 1 0 -1 -1 -4 -5 -6 -5 -4 -2 -1 5 7 12 14 14 13 10 7 9 4 3 3 3 1 0 3 5 7 6 7 10 10 8 7 5 4 3 5 5 6 6 5 6 3 24 27 25 29 31 31 38 43 43 48 51 53 53 52 53 51 52 54 59 62 63 65 65 65 68 48 47 47 50 50 47 44 43 43 43 43 41 45 46 42 35 30 28 21 18 15 13 12 8 6 2
 18 11 10 5 3 4 0 -1 -4 -5 -6 -5 -5 -4 -4 0 4 11 13 14 18 11 8 14 6 4 2 5 3 0 5 7 5 7 8 12 11 10 7 9 8 3 4 6 2 5 2 3 1 25 25 26 30 32 30 41 41 46 48 51 53 51 51 52 52 51 53 62 64 68 66 67 67 66 49 49 50 50 50 47 46 45 44 42 45 46 45 46 45 37 32 30 22 18 16 14 11 9 6 3
 18 15 13 8 6 7 0 -3 -5 -5 -7 -10 -6 -6 -2 0 5 9 12 9 13 12 10 12 5 6 6 6 9 5 6 6 6 9 13 12 12 13 10 9 8 6 5 3 3 4 1 1 1 25 29 29 32 36 36 38 42 46 50 54 54 53 52 51 51 51 52 63 65 66 68 67 69 71 51 54 51 50 50 51 48 48 48 48 49 48 50 46 47 39 33 30 23 19 17 14 13 10 7 3
 19 17 14 11 7 4 -1 -1 -3 -7 -7 -10 -8 -7 -5 1 3 7 7 5 8 8 8 11 8 8 9 12 13 9 7 7 8 15 14 14 14 14 13 10 8 9 5 3 3 4 2 2 -1 33 34 33 37 38 39 44 44 45 55 56 53 55 53 54 52 51 55 62 64 68 67 69 71 70 55 57 55 52 52 51 50 50 51 51 48 52 50 46 46 39 34 31 21 17 16 13 12 10 7 3
 22 19 15 13 10 5 0 0 -1 -6 -9 -9 -6 -6 -2 1 1 4 6 6 6 10 8 9 10 11 13 14 14 12 14 11 16 13 15 16 12 15 11 11 11 11 9 4 5 3 2 1 1 37 37 38 38 42 44 47 45 48 56 57 57 58 57 59 55 54 59 61 62 66 68 67 69 70 57 57 57 54 51 50 49 50 50 53 51 52 52 52 46 40 35 29 21 18 14 13 11 8 5 3
 23 22 18 13 12 10 6 8 4 2 0 -5 -8 -5 -3 -2 2 1 0 6 10 10 15 16 11 16 18 17 20 22 24 25 23 23 22 20 15 16 18 15 18 18 18 12 9 7 5 2 0 40 46 51 51 54 52 52 55 55 56 55 57 60 60 60 62 62 64 65 66 67 71 69 74 76 57 60 59 58 56 54 53 55 54 54 56 57 57 51 45 42 36 35 32 21 20 16 14 11 6 1
 29 25 20 20 17 12 12 11 9 5 2 -1 0 -3 -2 5 7 5 7 8 8 16 17 21 20 23 22 23 22 24 29 28 27 25 23 20 15 18 19 18 19 17 14 9 6 6 3 2 1 44 47 49 52 54 53 56 58 58 56 54 57 59 58 60 60 62 63 66 68 70 70 74 75 77 60 61 61 59 58 57 56 55 55 54 55 57 53 52 45 39 37 34 22 18 16 17 12 10 7 1
 32 26 22 21 20 16 17 15 13 9 5 0 2 4 1 5 7 7 11 11 11 19 20 21 22 26 23 27 28 26 29 28 29 27 22 19 16 15 17 17 20 17 15 11 8 4 3 3 0 45 48 49 52 54 56 56 58 57 57 56 57 56 56 58 60 62 63 65 68 69 70 75 75 73 61 63 64 60 60 60 54 55 55 56 57 56 52 50 46 37 34 33 25 19 19 16 14 9 7 1
 34 33 27 25 26 24 18 19 18 11 10 5 8 8 11 8 9 9 12 18 18 21 26 24 23 28 30 31 33 34 32 32 33 29 25 25 14 17 17 18 13 13 15 10 6 6 7 9 6 46 50 51 55 58 59 56 57 57 57 60 61 56 58 55 57 62 64 68 70 74 70 71 74 74 64 66 65 63 61 60 56 58 55 57 58 60 50 44 44 36 34 31 21 20 18 15 15 10 7 2
 38 36 35 32 30 28 26 22 21 15 13 10 11 10 11 14 12 13 19 20 22 27 29 30 29 29 30 35 37 36 37 36 36 31 28 25 16 17 17 14 11 12 13 10 8 7 8 11 8 46 48 49 56 58 60 59 60 59 62 62 61 57 57 54 60 64 65 68 71 70 69 72 74 75 64 65 65 63 63 64 60 60 59 59 59 58 48 45 40 35 35 30 22 17 18 14 12 10 8 4
 41 40 37 37 35 34 29 28 26 19 16 13 13 13 13 15 12 12 19 22 23 27 30 32 31 30 34 36 37 39 40 38 40 35 32 29 17 16 17 13 12 16 15 13 10 10 8 13 10 43 47 50 57 57 64 62 61 61 62 62 61 54 55 54 58 61 62 67 68 70 69 75 75 74 64 63 64 63 65 68 64 60 59 58 58 54 46 45 43 34 32 27 21 15 16 13 14 10 6 4
 44 44 44 40 40 39 37 32 26 25 22 14 16 19 19 22 22 19 21 27 31 31 32 33 33 35 36 39 40 42 43 40 36 34 32 29 18 17 18 19 19 18 14 14 14 20 19 15 14 45 49 50 52 57 60 64 63 63 62 62 61 53 55 53 55 61 60 65 70 72 72 72 76 74 62 65 64 65 69 68 67 64 60 59 57 55 47 41 39 37 32 29 22 16 16 15 11 9 7 4
 47 48 45 45 42 41 38 34 32 28 25 20 22 21 24 26 26 25 28 30 32 34 32 34 37 34 36 41 40 42 43 40 40 37 35 32 18 17 17 24 23 21 18 18 19 24 21 17 14 48 50 48 55 56 59 64 63 62 65 65 63 55 54 54 60 62 63 69 74 72 73 76 77 76 65 67 65 66 68 68 66 64 60 59 59 56 45 42 39 35 34 32 19 16 17 17 13 9 4 2
 49 48 49 48 46 43 39 36 36 33 26 24 25 24 24 30 28 29 33 32 34 38 37 42 40 37 40 44 43 43 46 42 40 37 37 35 21 22 25 27 26 25 22 22 24 26 23 19 15 50 51 50 56 58 59 63 64 63 67 63 61 57 55 54 60 62 61 70 75 76 76 75 75 75 62 67 69 64 68 71 66 65 64 57 55 56 47 44 40 37 35 30 19 18 17 16 14 9 7 0
 50 52 51 51 48 46 42 45 39 34 31 29 28 31 33 33 34 31 33 40 39 42 42 43 44 44 43 46 50 49 46 46 44 42 41 39 26 29 30 29 29 30 26 26 25 27 25 25 20 49 52 53 56 60 62 64 65 65 65 65 64 57 57 57 59 60 59 67 71 75 74 76 75 75 66 66 65 66 64 65 67 63 60 58 55 52 48 44 40 37 33 32 22 19 18 15 12 10 6 1
 52 53 53 54 52 50 48 49 44 38 36 32 34 34 37 39 37 38 40 44 43 43 43 47 46 45 48 52 51 52 47 47 45 42 42 40 32 32 32 32 30 30 31 28 26 28 29 28 22 55 54 56 59 60 60 63 64 65 66 64 62 60 60 60 61 59 62 69 70 72 73 72 74 73 66 65 64 64 63 66 63 62 58 55 53 54 47 44 42 37 33 30 22 22 19 16 14 12 7 3
 53 56 55 56 55 53 50 50 46 39 40 41 36 38 40 43 41 41 43 44 46 46 46 49 51 50 51 53 53 55 51 49 44 42 41 43 35 35 32 34 35 32 34 31 29 26 26 26 24 56 57 58 60 61 61 64 65 65 66 65 60 63 63 64 67 62 63 66 69 72 73 73 72 73 65 65 65 61 62 62 60 58 57 55 54 52 48 45 41 37 34 28 22 22 20 17 12 13 10 2
 56 57 56 56 57 54 58 58 59 59 63 65 64 63 65 62 61 59 61 59 56 57 52 52 54 51 47 43 45 46 45 44 45 43 42 40 38 39 40 36 38 38 38 38 35 35 31 30 25 58 60 57 57 57 59 60 62 61 62 66 67 73 77 74 79 80 80 80 76 75 73 72 73 70 66 64 62 60 56 56 54 53 51 51 50 49 48 42 37 34 29 27 20 15 13 10 6 2 4 0
 54 56 56 56 57 56 57 58 57 61 63 63 64 64 64 59 58 58 60 60 59 52 51 54 54 52 48 49 49 51 49 45 45 45 44 41 42 42 40 41 41 41 43 43 39 37 34 30 28 59 58 59 57 58 57 60 62 64 64 66 70 78 79 78 77 79 79 75 73 73 70 71 73 69 62 64 60 56 55 56 53 52 52 49 47 46 43 39 37 29 28 24 17 14 12 10 6 1 0 0
 54 54 56 56 55 53 56 58 59 62 63 61 67 65 63 59 57 58 57 57 57 51 52 54 54 52 49 50 55 53 52 47 50 47 44 44 46 43 41 43 41 43 44 42 38 38 32 33 29 60 61 59 60 57 56 61 62 63 69 69 72 78 78 77 79 77 76 73 72 70 67 68 69 65 59 59 60 56 56 57 52 51 52 49 47 46 39 38 36 27 26 28 18 16 11 10 7 2 2 -1
 53 53 55 55 54 53 57 59 57 61 59 57 66 65 65 60 59 57 55 54 52 53 57 57 56 56 56 55 61 61 54 52 51 48 50 47 44 48 46 44 46 45 42 44 40 40 41 40 36 60 61 59 60 57 56 61 65 70 71 76 77 79 77 78 75 74 74 71 67 65 63 62 65 64 53 54 52 56 57 56 53 50 49 49 46 43 42 37 30 25 26 23 19 15 14 11 8 2 -4 -5
 54 52 53 54 55 52 57 60 60 59 57 57 65 63 63 60 60 57 55 54 54 56 58 58 61 61 62 65 67 64 60 56 53 54 53 50 51 53 49 49 49 46 47 47 44 42 42 42 36 63 63 63 58 56 55 63 66 67 75 77 81 78 76 76 75 74 74 67 67 64 63 66 67 64 52 52 55 56 57 58 54 51 48 46 45 41 40 38 32 27 29 25 17 12 9 10 5 1 -3 -7
 54 52 55 50 51 50 56 58 60 59 60 60 66 66 61 60 60 59 56 55 54 59 57 59 65 65 64 69 70 67 63 61 58 57 53 51 51 53 53 49 50 54 50 50 47 43 44 42 39 62 63 60 55 55 57 63 66 69 76 79 81 77 77 75 75 76 73 69 66 65 63 62 65 61 50 53 56 55 58 57 52 49 46 44 40 37 40 36 31 28 27 26 18 12 7 8 6 0 -4 -9
 55 56 54 55 53 50 51 53 52 55 58 59 66 62 61 62 58 56 56 59 61 58 59 59 69 71 69 70 73 72 68 67 63 60 60 58 51 55 53 53 56 55 52 52 53 55 52 49 43 62 60 60 60 61 62 61 69 71 78 81 84 78 72 72 74 67 69 67 64 64 62 60 58 57 51 51 53 52 52 54 52 45 44 42 34 36 39 35 34 33 27 22 17 9 8 0 -4 -7 -10 -9
 58 58 58 56 56 52 53 55 52 55 58 58 62 61 61 60 61 58 60 60 61 59 59 60 74 73 71 73 75 74 71 71 66 64 61 60 57 58 58 60 59 59 53 50 51 56 52 48 45 61 60 61 65 65 63 68 69 74 79 79 81 74 72 73 71 66 69 64 62 61 60 59 57 54 50 49 50 50 50 52 47 43 42 37 35 35 35 33 31 29 29 24 11 7 4 -3 -5 -8 -8 -9
 59 58 60 58 55 52 53 51 50 54 56 53 62 60 62 61 59 59 59 63 63 63 63 63 76 75 74 74 73 71 71 69 68 67 64 63 62 62 59 61 62 61 56 52 54 56 50 50 48 63 64 63 66 66 65 72 74 76 81 80 85 75 74 75 73 69 66 64 61 64 59 59 54 52 49 48 45 50 51 51 45 42 40 35 33 36 31 34 34 27 25 23 10 5 0 -4 -7 -7 -8 -9
 61 63 62 57 55 55 50 52 50 52 54 55 58 60 62 59 60 60 62 64 63 67 71 70 77 78 76 74 77 77 69 73 75 69 72 71 64 71 71 66 65 63 57 56 56 56 49 53 54 66 67 68 68 67 69 75 77 78 80 83 87 78 76 77 73 67 66 63 58 57 54 52 52 50 47 48 49 47 49 49 45 39 37 35 35 33 34 27 25 23 16 15 7 0 -1 -3 -4 -7 -10 -9
 65 65 64 57 55 57 57 56 54 54 55 55 58 61 61 60 60 61 65 66 67 72 76 76 80 79 77 79 80 76 76 77 75 76 76 72 74 76 70 67 65 67 61 60 60 57 55 54 54 66 67 68 68 66 70 77 79 77 82 83 84 76 74 76 68 66 64 60 56 55 52 52 52 48 49 51 49 48 49 49 40 36 35 35 37 34 28 24 23 15 11 10 2 0 -1 -2 -7 -8 -9 -9
 67 66 66 60 59 60 59 58 59 55 55 55 57 58 61 60 63 63 65 68 67 72 76 76 83 80 79 79 78 78 75 78 74 79 78 73 76 76 72 70 69 69 64 62 63 60 59 57 55 67 67 71 69 70 69 78 77 77 80 81 80 77 74 76 68 66 63 58 55 55 50 50 49 44 52 52 49 48 48 46 44 36 37 33 32 35 26 24 21 10 10 8 2 -1 0 -1 -3 -4 -6 -8
 68 71 67 69 66 64 63 60 57 59 57 56 57 62 65 68 71 74 73 77 78 78 76 78 82 84 82 84 83 80 82 83 84 84 81 82 79 76 76 74 69 68 68 66 63 59 58 59 61 65 65 67 66 70 68 70 74 76 77 80 80 78 69 69 69 64 58 57 53 53 47 43 42 41 50 42 43 41 40 39 39 32 29 30 29 29 27 26 25 23 17 13 10 7 4 0 -2 -5 -8 -10
 71 72 70 69 70 68 62 57 58 59 60 58 62 63 66 72 74 73 78 77 78 79 77 78 84 85 85 83 82 82 85 83 84 83 82 81 79 77 76 71 70 69 69 66 62 57 58 59 58 67 67 68 73 72 73 74 76 77 79 80 77 71 67 70 68 64 61 54 53 50 46 45 42 39 43 40 39 43 42 41 36 30 31 28 26 29 24 23 23 21 18 14 8 6 3 -2 -3 -6 -7 -11
 75 73 72 69 67 66 65 61 60 61 60 58 61 64 64 75 75 76 77 81 80 80 79 79 84 85 89 83 83 80 84 85 85 86 85 85 83 79 75 71 72 74 68 60 59 56 58 56 55 69 68 70 73 76 76 73 77 76 79 76 74 69 69 67 66 62 58 51 51 45 44 37 40 40 44 42 42 45 42 41 38 34 31 28 26 29 25 24 22 21 18 15 8 4 3 -3 -5 -5 -7 -10
 76 76 74 70 71 69 67 64 63 60 61 58 63 63 66 75 77 77 84 88 85 83 85 87 85 86 86 85 83 86 86 86 85 88 86 85 80 75 74 72 72 70 63 61 56 59 58 61 60 67 71 70 76 78 81 76 75 77 75 71 69 70 68 66 64 56 54 49 45 44 42 36 30 32 44 43 43 44 42 44 41 35 33 29 29 29 25 22 20 21 16 13 9 2 -2 -5 -7 -13 -11 -11
 79 79 75 74 75 72 69 66 66 65 64 63 60 59 67 76 79 81 88 90 87 87 87 88 87 87 87 85 84 83 83 84 86 87 84 84 77 75 77 74 75 73 66 66 63 63 62 62 62 71 74 75 78 77 83 75 75 77 74 71 72 67 65 64 56 53 51 43 41 42 41 34 29 27 44 43 45 47 45 46 41 36 32 33 31 29 22 19 21 17 13 10 5 3 0 -5 -10 -16 -14 -12
 82 80 79 76 78 73 73 70 68 68 65 64 62 63 67 75 80 85 90 90 90 88 89 88 88 88 89 87 85 83 86 88 87 89 87 87 79 77 75 76 74 70 67 67 66 66 67 64 68 70 74 75 81 79 85 80 78 77 73 72 70 65 63 63 56 50 46 42 42 41 40 35 30 26 46 44 45 47 47 46 41 41 35 34 30 26 23 22 20 16 13 11 7 0 -1 -7 -9 -13 -13 -14
 81 80 80 80 76 76 76 73 68 68 65 65 61 68 66 73 81 83 89 95 94 93 94 94 89 86 85 81 86 85 87 87 85 85 88 89 80 79 80 79 76 72 70 71 70 69 68 68 67 71 72 72 76 81 83 82 75 74 72 68 65 60 56 54 52 48 46 43 38 36 34 30 27 25 47 46 46 44 45 45 44 38 34 30 24 24 23 16 18 14 8 8 3 0 0 -1 -6 -8 -12 -18
 82 80 79 78 75 78 77 75 75 68 67 66 68 69 71 78 81 86 95 99 98 95 96 95 90 88 85 86 88 87 87 85 84 86 89 88 81 80 80 79 76 72 73 74 72 70 69 69 67 72 70 72 77 80 80 73 73 72 67 66 66 58 55 55 50 46 45 37 36 35 33 29 25 23 42 43 42 42 43 43 34 32 28 22 22 21 16 13 11 7 5 4 1 2 1 -1 -4 -8 -13 -18
 83 80 79 80 76 79 79 78 74 71 71 68 72 72 72 77 82 85 92 94 93 94 93 94 92 91 86 87 88 89 90 86 88 89 89 91 82 82 82 79 76 75 75 75 72 72 69 70 69 75 72 74 76 78 77 73 69 67 66 65 64 58 55 55 51 46 45 35 36 33 32 30 27 23 39 40 36 38 39 39 32 28 23 20 19 19 15 11 10 3 4 0 0 0 0 0 -5 -9 -13 -20
 83 81 77 80 81 80 81 80 77 74 74 72 73 72 71 82 85 89 90 90 91 95 96 98 91 90 89 89 90 91 90 90 87 86 87 88 86 84 84 78 75 73 76 75 73 73 76 78 73 75 75 76 74 72 74 67 66 64 63 63 63 58 59 56 48 46 43 33 31 30 30 28 28 26 35 35 34 35 36 35 24 22 18 16 17 17 10 6 4 2 2 2 0 1 0 0 -3 -7 -14 -18
 83 80 79 82 83 85 83 80 78 75 75 75 75 76 78 82 86 89 92 92 92 95 98 100 95 94 92 93 92 95 92 92 91 89 88 90 87 85 84 78 74 73 76 78 75 73 77 78 77 76 78 74 73 72 72 67 65 66 63 61 60 55 55 54 46 42 39 33 30 32 29 31 29 26 33 33 29 35 34 33 24 20 17 18 18 18 10 9 5 2 0 2 0 0 -4 -2 -7 -9 -15 -18
 81 79 80 84 84 84 84 82 81 76 75 75 79 80 80 85 86 87 93 95 94 97 98 97 97 97 96 94 94 94 94 95 91 86 88 89 86 85 83 78 75 74 80 80 78 73 75 76 76 80 80 78 70 70 69 64 64 64 61 61 60 51 50 50 40 36 37 32 31 32 27 29 28 27 29 30 30 29 29 28 20 18 15 17 17 17 9 10 7 0 -1 -1 -2 -3 -4 -4 -8 -12 -15 -20
 83 82 84 82 87 90 88 86 83 82 79 77 81 84 82 84 86 87 91 93 97 98 98 99 97 98 98 95 96 94 97 96 96 92 91 91 87 84 84 79 78 77 79 78 77 73 73 76 80 78 78 73 69 66 65 62 59 62 59 58 57 52 50 49 40 35 37 33 30 32 28 32 30 30 30 29 26 25 25 26 17 17 14 15 14 15 7 7 6 0 0 -1 -6 -6 -11 -7 -12 -15 -21 -21
 88 85 83 86 85 87 88 83 81 82 85 89 94 89 89 85 83 82 85 85 85 85 85 84 86 84 85 86 85 85 87 84 83 80 75 75 77 75 74 76 77 80 80 81 82 83 82 84 82 79 82 80 80 80 79 78 76 74 72 68 65 61 59 57 55 52 50 52 49 48 43 46 42 36 34 27 26 24 21 19 17 14 13 13 7 9 6 3 0 -1 -4 -2 -3 -8 -13 -15 -16 -21 -25 -25
 84 82 83 81 81 82 79 79 78 78 82 88 85 86 84 80 81 82 81 84 83 82 82 82 81 80 82 79 82 85 85 86 81 74 73 76 73 74 76 74 75 77 78 79 81 81 83 84 83 82 84 83 84 83 83 79 77 75 70 69 65 58 58 57 51 49 50 47 45 45 41 43 43 38 28 26 26 22 21 19 15 13 13 9 7 5 4 4 0 -5 -8 -5 -8 -10 -13 -17 -20 -22 -24 -26
 84 83 78 80 78 80 75 74 76 71 80 83 80 82 80 77 78 77 77 78 77 79 82 83 78 78 83 74 77 81 82 80 77 73 71 72 71 75 77 75 75 75 78 77 80 78 82 82 82 86 84 84 86 85 83 82 79 77 68 66 61 57 56 54 53 50 49 46 45 43 37 37 37 37 27 24 25 22 19 16 15 12 12 8 7 8 2 1 0 -7 -8 -6 -12 -12 -13 -18 -21 -21 -25 -27
 84 82 79 75 72 70 71 66 65 71 74 76 77 73 74 74 72 72 72 72 75 81 81 80 77 74 73 75 78 78 77 75 73 70 67 67 74 73 74 74 71 70 72 70 75 75 78 74 78 81 85 85 87 88 90 82 80 78 68 61 58 55 54 53 51 51 50 45 41 38 35 33 28 29 22 22 21 21 19 17 13 7 6 7 8 8 2 -1 -4 -8 -9 -12 -13 -16 -14 -18 -21 -27 -29 -27
 80 80 76 71 72 69 63 63 62 69 72 75 67 67 70 69 68 69 68 69 73 77 79 80 74 72 71 75 77 78 73 73 69 64 63 66 71 71 70 67 66 66 66 66 69 73 74 72 75 81 85 86 88 88 89 83 80 74 65 59 57 55 56 52 49 49 49 42 39 37 34 29 26 25 18 18 19 16 18 14 9 4 7 6 7 6 -1 -2 -4 -8 -9 -12 -14 -16 -17 -20 -24 -29 -29 -27
 79 75 70 64 65 63 57 60 59 66 70 72 60 63 62 64 66 65 65 67 73 75 78 79 71 71 70 73 73 76 70 68 66 62 62 66 68 69 67 66 65 64 67 66 69 71 74 73 75 80 84 83 88 90 90 85 79 73 64 60 57 57 56 48 51 49 46 41 38 35 31 31 26 26 15 15 15 13 13 13 7 5 5 5 6 4 -3 -1 -1 -10 -9 -12 -19 -15 -18 -20 -21 -28 -28 -27
 74 68 69 68 64 62 57 59 60 61 61 64 58 54 56 58 61 61 64 67 69 70 75 75 71 71 70 69 67 65 66 59 60 61 58 58 64 62 65 67 62 62 64 68 71 69 73 72 75 82 84 84 87 91 89 87 75 71 66 58 55 57 53 50 47 45 45 41 37 35 30 29 22 21 13 14 15 15 14 14 9 8 5 5 5 3 -2 -3 -6 -4 -9 -12 -15 -19 -18 -21 -22 -25 -26 -27
 69 68 66 65 66 60 56 56 57 55 58 63 49 49 51 54 56 58 64 66 67 69 73 75 69 71 68 68 66 67 58 53 56 53 51 52 59 60 63 62 62 60 66 70 70 70 72 72 76 83 85 87 87 88 89 77 74 70 62 60 57 53 51 50 48 47 46 38 38 33 29 26 21 21 14 13 14 16 14 12 8 9 9 5 4 2 -4 -5 -3 -6 -11 -12 -15 -18 -21 -21 -24 -26 -26 -28
 68 67 69 61 61 60 53 54 55 52 56 60 48 47 50 51 54 59 60 65 65 67 69 71 67 68 68 67 64 64 60 53 50 49 49 49 55 56 57 61 62 60 67 69 71 72 73 74 75 85 86 85 87 85 83 76 71 69 62 59 58 51 53 49 49 46 44 38 34 31 28 27 22 21 15 14 16 17 16 14 11 11 7 8 5 5 -5 -5 -1 -7 -9 -14 -14 -18 -22 -22 -24 -28 -30 -29
 65 63 61 60 56 52 54 47 45 50 50 53 46 44 44 50 52 56 60 60 60 65 63 63 66 65 65 66 59 57 55 52 51 46 48 47 51 51 57 58 61 61 67 70 75 73 75 76 79 86 86 87 83 78 79 72 64 64 62 57 56 52 48 50 47 43 41 37 32 31 26 26 24 24 14 17 15 15 13 13 11 6 4 7 6 6 -3 -3 -3 -6 -10 -14 -14 -19 -21 -22 -26 -27 -30 -31
 62 61 59 55 55 53 47 44 43 45 48 48 39 40 41 46 50 53 58 61 62 62 59 63 63 63 65 60 56 55 52 51 50 48 49 46 47 48 51 59 61 61 68 71 73 72 75 76 78 86 86 84 79 76 75 66 61 63 58 55 55 50 45 46 44 40 38 38 33 31 27 26 24 22 15 17 17 15 15 14 6 4 5 6 6 5 0 -1 -4 -7 -8 -12 -16 -19 -21 -23 -25 -28 -29 -32
 57 57 56 50 50 48 44 44 43 40 42 41 39 38 40 44 48 56 58 58 61 58 61 65 62 60 61 61 56 54 51 50 47 46 48 44 49 48 53 60 61 62 69 70 74 74 76 77 80 86 86 83 77 73 74 66 63 66 60 55 59 51 47 47 44 41 41 34 34 32 29 28 26 19 12 13 15 14 12 9 7 5 5 7 4 4 -2 -2 -2 -10 -9 -13 -15 -17 -21 -23 -27 -28 -32 -31
 53 52 50 50 44 41 42 39 36 36 37 39 37 39 40 41 44 45 48 50 49 51 55 57 61 58 57 58 55 54 51 48 47 45 41 38 46 49 52 54 57 57 61 65 67 70 72 75 77 86 79 78 74 69 70 67 62 57 55 53 51 50 46 46 42 41 37 36 31 29 21 21 17 18 12 11 11 13 12 10 7 6 6 5 4 3 1 -5 -8 -12 -20 -21 -21 -25 -27 -29 -31 -31 -34 -36
 52 52 49 44 41 42 37 35 34 36 37 37 34 37 38 39 43 45 46 46 46 47 53 57 58 57 58 56 55 50 49 49 45 42 41 42 47 48 51 54 55 57 60 64 68 71 73 74 78 82 79 76 69 69 69 65 61 56 52 52 51 48 48 44 41 42 41 32 29 25 17 16 15 14 9 8 10 9 10 8 2 3 4 1 4 1 -4 -6 -10 -19 -21 -19 -22 -25 -25 -29 -30 -31 -34 -37
 50 50 50 44 40 38 33 34 34 36 37 40 32 34 36 36 39 41 45 42 43 44 48 53 59 57 58 52 52 50 50 49 47 44 43 42 45 48 49 49 54 56 61 65 70 70 75 77 82 79 77 72 69 68 67 65 59 52 50 48 48 47 45 43 41 41 38 30 25 20 13 9 11 8 11 9 9 5 7 4 0 0 1 1 0 -2 -8 -10 -16 -20 -20 -16 -22 -26 -29 -27 -30 -31 -34 -38
 48 44 43 43 40 36 33 34 31 35 36 35 31 31 34 35 38 39 42 37 33 40 44 48 57 54 54 50 46 42 46 43 46 46 46 49 47 47 48 50 48 50 58 64 68 67 72 76 79 80 73 72 67 63 64 61 55 51 45 43 41 45 43 42 37 39 36 26 19 15 10 9 7 1 8 10 9 5 0 -1 -2 -3 -3 -2 -4 -9 -12 -17 -19 -20 -17 -18 -21 -22 -23 -27 -31 -31 -32 -37
 45 45 47 39 36 38 33 31 32 34 34 34 31 32 33 32 35 37 35 34 33 38 41 43 51 50 48 45 44 43 42 41 43 45 46 47 46 44 43 47 47 49 57 62 65 65 71 76 78 73 71 69 66 63 63 61 57 53 45 42 42 44 46 42 37 41 39 22 17 15 11 9 6 0 7 9 6 0 -2 -4 -6 -5 -4 -4 -5 -6 -17 -17 -17 -17 -15 -15 -21 -22 -24 -26 -29 -30 -33 -36
 45 43 45 42 35 37 30 29 31 31 35 31 29 30 29 31 30 35 31 32 32 37 37 40 50 46 43 41 41 39 38 40 43 43 47 47 46 45 44 44 46 49 54 58 62 64 69 70 77 69 70 69 68 65 61 61 57 50 45 42 39 42 42 40 38 36 35 26 19 15 10 7 3 -2 3 2 1 -4 -5 -5 -10 -10 -6 -7 -6 -7 -18 -19 -19 -16 -14 -17 -20 -21 -23 -24 -29 -28 -30 -35
 44 36 34 35 31 30 30 32 29 28 30 31 28 24 24 22 24 30 29 28 29 31 34 39 46 46 42 40 40 38 37 39 42 45 46 48 45 44 41 42 45 45 52 60 57 61 67 69 74 69 69 66 66 63 63 58 50 50 45 38 35 39 34 33 33 31 30 25 13 8 0 -2 -7 -9 -1 -7 -10 -10 -11 -10 -13 -13 -16 -15 -11 -9 -20 -19 -22 -20 -17 -17 -19 -23 -24 -25 -24 -27 -29 -33
 36 32 31 30 29 29 29 29 27 25 28 31 23 22 21 21 23 24 26 25 28 30 33 36 45 45 41 39 38 38 38 39 42 46 46 47 48 47 46 44 46 50 60 63 62 61 66 70 74 71 71 71 63 60 60 49 48 46 38 33 34 33 31 30 27 29 28 15 12 4 -2 -5 -10 -11 -8 -11 -11 -14 -14 -14 -13 -14 -15 -16 -11 -10 -18 -17 -17 -18 -18 -18 -23 -26 -24 -28 -28 -27 -30 -34
 33 32 31 29 27 26 27 26 20 22 24 29 25 22 19 19 23 26 27 26 23 32 35 34 44 43 40 38 38 39 39 39 43 44 47 45 46 45 45 46 48 51 59 61 60 59 63 67 75 71 69 68 62 60 54 48 44 41 37 34 35 32 29 28 24 22 19 9 6 0 -6 -10 -13 -13 -14 -14 -15 -12 -16 -18 -15 -17 -17 -17 -13 -12 -18 -16 -18 -18 -17 -19 -20 -26 -24 -28 -30 -28 -29 -32
 32 32 30 24 23 23 21 19 19 24 27 29 19 16 13 19 23 27 28 28 27 32 34 34 40 39 39 37 36 38 41 42 42 46 47 47 44 42 42 48 51 53 59 58 59 59 64 68 72 68 68 67 59 57 52 42 39 37 31 30 30 26 25 24 16 14 11 1 -2 -7 -11 -14 -17 -18 -17 -18 -17 -20 -21 -19 -20 -20 -21 -16 -14 -11 -16 -15 -16 -18 -18 -20 -24 -27 -26 -28 -28 -31 -31 -31
 32 31 31 22 23 20 21 22 22 23 25 27 20 20 22 26 28 32 29 31 30 33 32 33 39 39 38 37 40 38 40 42 44 44 47 49 45 46 46 49 55 58 63 62 61 61 66 70 71 70 67 65 58 54 51 39 39 34 29 29 28 25 24 18 13 13 10 1 -5 -10 -14 -16 -18 -18 -19 -17 -20 -21 -20 -21 -21 -24 -21 -12 -10 -9 -18 -16 -15 -16 -19 -20 -23 -24 -26 -29 -31 -29 -31 -31
 30 30 28 22 21 21 23 23 21 23 23 25 24 24 22 30 32 30 30 32 30 31 30 34 39 38 39 41 42 43 43 43 43 46 47 45 48 48 47 56 57 59 64 65 65 64 68 72 73 71 70 65 54 52 47 37 36 33 30 30 27 23 22 18 11 11 6 -5 -7 -11 -15 -16 -17 -20 -18 -17 -21 -19 -18 -21 -27 -27 -25 -10 -7 -10 -18 -18 -17 -18 -19 -19 -23 -23 -25 -28 -27 -27 -27 -30
 26 28 31 22 22 22 21 21 20 22 22 26 27 25 25 30 32 31 32 32 32 31 32 35 38 38 37 43 42 48 44 44 46 46 47 46 47 49 52 54 59 57 63 64 67 66 68 73 76 73 68 61 52 50 45 36 35 29 27 28 27 22 19 17 8 5 2 -5 -10 -10 -16 -21 -20 -24 -20 -22 -24 -21 -22 -24 -25 -24 -22 -15 -13 -13 -19 -16 -16 -17 -18 -18 -22 -21 -25 -27 -29 -29 -30 -30
 27 30 32 35 33 35 37 36 37 35 37 36 33 34 31 33 35 34 37 33 33 33 34 34 35 37 36 39 38 38 41 44 46 49 51 50 52 54 54 55 54 55 56 61 64 63 63 68 71 69 62 58 56 53 50 48 44 41 39 29 27 23 17 12 8 5 0 -4 -5 -6 -8 -13 -16 -17 -26 -22 -21 -18 -12 -10 -10 -6 -6 -4 -6 -5 -6 -6 -7 -7 -9 -13 -16 -21 -22 -23 -24 -27 -31 -31
 27 28 33 31 31 33 35 33 33 35 38 36 35 35 34 36 35 39 33 31 31 32 33 32 33 35 35 37 37 38 39 44 47 49 50 51 55 56 55 53 54 54 59 62 62 61 63 68 71 66 64 61 55 54 51 46 45 44 33 27 25 21 16 13 10 11 4 -1 0 -4 -6 -10 -13 -18 -22 -20 -17 -9 -5 -5 -3 -2 -2 0 -3 -3 -8 -7 -7 -9 -9 -14 -18 -19 -23 -22 -24 -26 -28 -31
 25 27 29 33 32 34 34 33 29 32 36 33 34 36 34 34 36 38 30 29 31 28 29 29 32 34 35 37 36 39 38 44 48 51 49 54 55 56 52 55 53 55 57 58 63 60 61 68 74 64 63 57 57 55 50 48 46 43 34 29 26 25 18 17 11 10 5 4 1 0 -2 -6 -11 -16 -22 -20 -14 -5 -2 -3 0 1 2 1 -2 0 -5 -6 -8 -10 -10 -10 -18 -20 -22 -23 -24 -23 -25 -29
 27 29 31 32 33 31 36 31 29 30 34 30 35 34 34 34 32 36 29 27 28 26 28 29 31 32 30 34 35 35 38 42 47 49 50 53 54 55 52 53 53 52 55 55 58 59 66 73 75 67 64 65 57 53 51 49 43 38 33 29 25 23 20 16 12 11 5 2 4 3 1 -4 -7 -9 -21 -14 -11 -3 0 1 5 9 10 4 4 3 -5 -4 -6 -10 -12 -12 -19 -17 -19 -20 -22 -21 -25 -27
 26 28 30 31 33 33 33 32 31 34 37 36 32 33 32 30 29 32 30 27 25 26 29 28 29 31 30 32 33 34 35 37 42 47 51 52 57 57 56 55 53 52 53 54 58 60 67 74 74 67 65 62 57 53 53 47 42 40 33 29 25 26 21 18 15 14 10 6 5 3 1 -1 -8 -9 -16 -14 -7 1 2 6 14 12 11 9 7 5 -4 -4 -4 -11 -11 -14 -15 -14 -17 -18 -19 -19 -23 -25
 25 27 30 32 30 33 36 32 33 34 34 36 32 33 31 30 30 33 29 28 24 25 26 25 28 27 29 29 30 29 32 38 40 48 50 50 57 58 57 56 52 54 54 55 59 62 66 74 73 68 68 62 62 56 55 48 44 40 33 28 23 27 24 23 16 16 12 8 5 1 1 0 -3 -3 -15 -11 -7 3 8 14 16 15 13 10 7 5 0 -3 -5 -11 -10 -12 -16 -13 -17 -18 -20 -19 -18 -23
 24 28 30 32 31 34 31 34 36 37 35 38 31 36 36 36 36 30 30 27 28 24 19 19 24 27 30 30 29 27 33 37 42 43 47 51 59 57 58 56 51 51 57 63 63 67 70 77 79 72 67 63 60 59 56 50 44 41 35 30 21 27 24 22 19 19 16 9 9 8 8 6 7 5 -11 -2 6 7 16 20 18 17 16 13 9 7 -1 -4 -6 -8 -8 -9 -13 -13 -16 -12 -14 -11 -13 -19
 24 28 30 35 34 32 33 35 37 35 34 37 35 37 35 36 37 32 25 24 24 20 18 18 26 27 29 27 27 30 37 39 40 45 47 49 56 56 56 54 51 54 61 64 66 67 72 78 81 73 71 67 62 59 56 47 43 37 35 34 25 25 25 21 19 23 18 13 12 10 10 10 8 8 -2 0 3 14 18 18 18 17 16 12 11 9 0 -1 -4 -4 -4 -6 -9 -11 -11 -9 -10 -9 -14 -17
 26 31 34 34 31 28 30 34 36 37 37 38 35 35 34 32 34 33 24 22 23 19 14 13 27 26 26 31 28 28 37 40 40 46 48 50 58 56 57 58 56 60 60 64 66 70 73 76 82 79 75 69 65 63 56 49 43 39 32 31 24 25 22 19 16 19 21 19 14 14 13 14 13 15 2 3 8 11 15 18 18 14 12 14 13 10 0 0 0 -3 -2 -4 -8 -9 -7 -6 -8 -6 -9 -15
 25 31 33 32 28 25 31 34 36 38 41 40 34 34 32 32 31 28 24 19 19 15 10 12 26 28 27 28 32 33 35 41 43 47 47 48 56 57 59 59 62 64 61 66 70 71 78 80 85 81 77 73 69 64 61 50 44 42 33 29 24 22 21 19 16 19 18 17 18 18 17 17 22 18 4 9 14 14 15 17 17 14 14 15 16 17 2 1 0 0 1 1 -2 -1 -3 0 -3 -1 -3 -7
 24 28 30 25 26 26 28 31 33 38 40 40 36 35 33 32 31 27 20 18 18 12 8 8 27 29 27 31 35 34 38 42 44 45 46 48 53 57 59 62 64 68 69 69 70 74 79 82 85 83 79 78 70 65 61 52 47 43 35 32 26 19 21 20 17 18 19 21 20 19 18 22 24 23 10 10 13 16 16 18 17 15 16 18 20 19 7 4 6 8 5 4 3 0 1 0 0 1 0 -3
 19 23 23 22 23 23 28 30 30 34 38 39 35 36 34 28 28 30 23 20 16 11 8 9 30 26 29 30 34 32 35 42 41 45 46 47 53 54 56 64 65 69 74 75 76 77 79 84 85 86 81 81 72 66 64 53 47 48 36 33 26 22 21 19 20 20 24 22 22 22 21 23 24 26 12 13 15 18 20 21 20 18 21 20 22 18 13 12 13 12 11 10 3 2 3 0 1 1 1 0
 14 17 17 18 18 19 20 24 25 25 32 33 37 30 28 23 18 15 13 12 12 12 10 9 29 31 33 36 38 36 37 40 44 47 47 46 51 56 57 58 64 66 69 74 76 76 79 83 87 89 82 78 74 68 63 59 53 49 45 34 30 22 25 23 21 19 18 15 21 22 23 26 27 26 18 20 19 18 18 18 16 19 21 20 21 22 18 17 16 17 16 15 12 11 11 9 6 4 4 2
 15 20 20 17 18 19 23 25 24 27 31 33 30 27 24 20 19 18 15 14 15 12 10 9 26 30 34 35 37 38 38 41 46 49 49 48 56 56 56 60 63 67 73 77 76 77 83 84 84 84 83 80 75 71 66 59 57 54 43 35 30 29 31 30 25 23 19 21 22 23 24 23 27 26 26 24 23 22 20 18 21 22 23 24 23 22 18 18 18 16 16 14 13 13 10 8 5 5 2 0
 13 16 16 17 15 19 22 21 22 25 27 32 30 25 22 19 20 20 19 14 12 12 10 11 25 27 31 33 36 34 40 42 43 52 51 50 54 58 59 62 65 69 74 74 75 78 82 83 85 82 83 82 76 73 68 61 57 55 45 38 32 32 32 33 26 25 20 24 24 23 25 25 28 27 31 29 24 26 23 18 21 25 24 27 24 21 17 19 20 20 14 15 9 11 10 8 3 3 0 0
 10 13 17 15 14 13 20 17 17 21 24 29 28 21 23 21 19 20 16 18 22 14 11 13 21 23 24 32 33 35 38 44 46 50 51 51 56 58 59 64 66 68 71 73 76 78 79 83 87 82 82 81 79 70 71 63 59 58 46 38 32 32 35 35 30 25 22 24 27 27 28 27 27 26 36 32 30 28 25 25 25 24 27 27 25 25 20 21 22 17 16 12 8 8 8 6 6 2 0 -3
 11 12 12 11 13 13 12 10 14 17 20 22 24 20 20 21 20 23 19 19 16 13 13 13 20 22 25 29 30 33 38 42 44 49 51 54 56 57 59 64 65 68 74 74 78 80 83 83 89 82 79 79 74 71 73 64 61 58 47 41 34 34 35 33 28 23 23 27 27 27 28 26 26 27 35 33 33 28 28 23 26 24 25 24 23 24 21 20 19 16 15 14 8 5 4 4 2 1 -2 -3
 7 9 8 9 10 10 12 10 14 13 17 19 24 22 25 23 23 26 20 17 14 12 12 12 19 19 24 27 28 32 37 40 43 49 49 52 56 58 58 63 65 69 75 76 80 82 83 85 90 83 80 81 75 72 73 64 61 60 51 45 38 38 36 37 32 26 26 30 27 29 27 26 23 26 35 34 32 31 29 29 24 25 25 25 22 25 21 20 24 13 14 9 6 5 3 4 7 1 0 -4
 8 12 12 12 12 10 11 13 13 14 17 17 26 23 21 21 21 20 22 16 14 13 13 15 15 20 20 23 26 29 36 39 42 45 51 54 57 62 62 64 69 68 75 78 79 78 84 90 93 83 82 81 82 78 75 68 62 56 51 44 38 39 36 37 37 34 32 30 31 31 36 36 35 31 40 35 33 35 33 30 26 27 25 25 25 25 21 17 18 14 14 11 8 5 5 6 3 0 0 -4
 11 13 11 11 12 12 13 17 18 16 18 16 22 20 19 17 20 20 17 13 12 11 13 13 17 19 19 23 27 31 33 36 39 45 50 53 59 62 62 65 67 70 76 76 76 74 81 89 93 87 82 82 81 77 74 65 63 55 49 46 41 40 38 40 38 36 34 31 32 36 38 38 37 36 36 32 33 35 35 32 32 29 26 28 27 27 22 18 17 16 19 14 9 7 5 8 6 1 0 -1
 8 10 10 10 11 14 11 14 14 20 21 18 18 18 18 14 17 22 13 9 11 9 10 15 17 18 19 23 28 26 32 34 38 43 49 53 56 60 61 65 67 66 76 74 72 71 76 86 87 90 86 83 82 78 76 62 62 56 48 45 42 44 43 44 42 38 34 37 36 38 41 39 39 37 35 34 34 34 32 33 33 30 28 26 30 29 23 19 17 17 18 18 11 10 7 8 7 3 1 -1
 7 9 9 10 9 8 12 14 17 22 20 20 14 12 12 15 17 18 10 10 7 6 8 9 17 19 20 26 29 31 33 34 37 49 51 52 57 58 58 65 66 70 70 69 68 68 72 78 87 90 88 85 78 77 73 59 56 53 45 44 41 46 47 46 42 39 39 39 41 41 44 45 42 41 40 38 35 32 32 31 32 29 28 29 29 31 23 20 17 16 16 16 12 11 10 8 8 6 3 1
 3 5 9 11 11 11 9 12 17 22 19 18 15 11 10 13 16 16 7 7 3 6 8 10 17 22 21 23 24 30 33 35 38 47 50 53 54 56 61 69 67 68 71 72 68 70 76 83 90 91 91 84 78 76 75 62 60 58 50 46 42 49 47 47 46 43 43 37 40 45 44 43 43 45 40 38 38 33 35 36 38 34 37 30 31 33 26 27 25 23 21 20 11 12 10 10 6 4 0 1
 2 2 6 11 12 11 10 10 14 18 19 17 13 11 11 15 15 12 5 3 4 6 7 10 18 21 21 19 20 24 36 37 37 48 51 52 54 55 56 67 67 67 74 75 76 75 80 87 90 90 90 87 78 77 73 66 65 60 49 48 45 50 49 49 46 46 45 39 38 43 44 45 46 45 41 40 35 36 37 39 41 41 37 34 34 34 33 33 31 24 25 24 14 11 9 11 7 0 0 2
 0 2 5 10 11 8 9 9 10 15 16 15 10 11 12 14 13 12 2 5 6 8 10 10 15 19 21 22 20 26 34 34 39 45 48 48 55 55 58 66 68 69 78 76 72 79 87 88 92 91 89 85 78 77 73 68 66 67 56 53 48 50 50 51 47 46 45 43 42 44 45 49 48 50 43 40 39 36 39 40 41 40 37 36 36 36 35 36 33 31 29 28 16 14 13 12 8 2 1 0
 0 1 5 9 10 9 10 9 9 11 11 12 12 12 11 11 10 9 8 9 8 10 11 12 12 13 15 20 22 24 29 32 34 40 45 49 55 59 62 66 69 70 74 76 80 84 85 88 92 93 89 86 79 76 74 70 70 66 61 59 56 53 53 51 48 47 48 47 47 47 47 48 47 46 44 41 40 39 41 42 42 41 40 40 38 38 38 38 37 34 32 30 24 19 16 12 8 4 2 0
