 0 0 0 -2 -4 -2 -3 0 -3 0 0 4 0 1 -1 -1 -1 -1 4 0
 -1 -1 -1 -3 -6 -10 -6 -2 1 2 0 2 0 -4 -4 -1 -1 -3 0 -1
 -3 -5 -4 -5 -6 -7 -8 -5 -4 1 1 0 -4 -5 -6 -5 -4 -3 -4 0
 -2 -6 -5 -6 -6 -10 -10 -7 -5 -1 -2 -3 -6 -9 -7 -8 -5 -2 -4 0
 -4 -7 -9 -10 -10 -13 -16 -11 -7 -1 -4 -8 -10 -13 -8 -7 -8 -5 -2 0
 -4 -5 -7 -8 -9 -6 -8 -4 -8 -2 -7 -12 -10 -6 -11 -5 -7 -5 -3 -2
 -5 -5 -3 -6 -7 -5 0 -6 -8 -2 -11 -16 -11 -8 -12 -9 -5 -2 0 -4
 -6 -7 -10 -10 -7 -4 -7 -8 -8 -5 -10 -12 -10 -8 -8 -7 -4 -2 -3 -4
 -5 -8 -10 -10 -4 -7 -7 -6 -7 -8 -8 -11 -11 -9 -9 -9 -3 -6 -1 -3
 -6 -7 -5 -5 -4 -5 -6 -8 -7 -9 -4 -4 -7 -7 -6 -7 -8 -4 -3 -1
 -9 -10 -7 -4 -8 -10 -8 -10 -9 -8 -8 -7 -5 -4 -4 -8 -7 -1 0 3
 -11 -11 -9 -14 -11 -10 -9 -11 -14 -9 -10 -8 -6 -4 -1 0 -5 5 7 6
 -7 -12 -12 -17 -16 -13 -13 -12 -11 -9 -8 -3 -3 -2 -2 1 4 10 9 7
 -8 -13 -18 -18 -16 -12 -11 -11 -7 -9 -6 -5 -4 -1 -2 3 5 8 6 10
 -7 -10 -19 -21 -19 -16 -10 -9 -9 -10 -8 -5 -6 -5 -1 4 9 8 10 8
 -4 -9 -16 -18 -18 -12 -11 -12 -9 -12 -11 -7 -10 -8 -5 0 6 5 6 6
 -2 -8 -15 -18 -14 -12 -11 -12 -16 -13 -13 -14 -8 -9 -6 -3 0 2 2 4
 -4 -6 -10 -12 -10 -10 -11 -14 -14 -14 -12 -14 -8 -9 -5 -1 1 0 1 3
 0 -1 -8 -13 -11 -11 -12 -16 -13 -14 -14 -11 -10 -10 -5 -4 1 0 0 2
 0 -1 -2 -7 -10 -12 -13 -14 -15 -16 -14 -12 -11 -9 -6 -2 -1 -1 -1 0
